X,Y,VaccinationDate,VaccineText,Dose1,Dose2,SingleDose,Dose1Cum,Dose2Cum,SingleDoseCum,PartiallyVacc,FullyVacc,PartialPercent,FullyPercent,ObjectId
-856336.314876336,7036491.65084485,2021/04/07 23:00:00+00,Thu 08 Apr 2021,20201,10574,17,755616,322893,207,755823,323100,15.7511723929821,6.73332751209279,1
-856336.314876336,7036491.65084485,2021/07/17 23:00:00+00,Sun 18 Jul 2021,16872,15826,1931,2858798,2362758,168455,3027253,2531213,63.0872358742354,52.7498797024665,2
-856336.314876336,7036491.65084485,2021/10/26 23:00:00+00,Wed 27 Oct 2021,1568,1433,6,3615135,3552538,240836,3855971,3793374,80.3575228106839,79.0530161493577,3
-856336.314876336,7036491.65084485,2021/04/08 23:00:00+00,Fri 09 Apr 2021,20687,9170,16,776303,332063,223,776526,332286,16.1826180119324,6.92476157747838,4
-856336.314876336,7036491.65084485,2021/04/09 23:00:00+00,Sat 10 Apr 2021,11187,4185,12,787490,336248,235,787725,336483,16.4160025207778,7.0122260639168,5
-856336.314876336,7036491.65084485,2021/07/18 23:00:00+00,Mon 19 Jul 2021,24909,18455,6253,2883707,2381213,174708,3058415,2555921,63.7366445772123,53.2647885733077,6
-856336.314876336,7036491.65084485,2021/10/27 23:00:00+00,Thu 28 Oct 2021,2159,1701,5,3617294,3554239,240841,3858135,3795080,80.4026200583972,79.088568785494,7
-856336.314876336,7036491.65084485,2021/04/10 23:00:00+00,Sun 11 Apr 2021,2869,368,9,790359,336616,244,790603,336860,16.4759793594649,7.02008265466908,8
-856336.314876336,7036491.65084485,2021/07/19 23:00:00+00,Tue 20 Jul 2021,30601,18194,7699,2914308,2399407,182407,3096715,2581814,64.5348075104006,53.8043925636222,9
-856336.314876336,7036491.65084485,2021/04/11 23:00:00+00,Mon 12 Apr 2021,7788,2807,13,798147,339423,257,798404,339680,16.6385503527234,7.0788507870866,10
-856336.314876336,7036491.65084485,2021/10/28 23:00:00+00,Fri 29 Oct 2021,2145,1379,2,3619439,3555618,240843,3860282,3796461,80.4473630301349,79.117348498568,11
-856336.314876336,7036491.65084485,2021/07/20 23:00:00+00,Wed 21 Jul 2021,30371,19852,6894,2944679,2419259,189301,3133980,2608560,65.3114012886059,54.3617728720049,12
-856336.314876336,7036491.65084485,2021/04/12 23:00:00+00,Tue 13 Apr 2021,11528,8594,1,809675,348017,258,809933,348275,16.8788119834474,7.25796855238043,13
-856336.314876336,7036491.65084485,2021/10/29 23:00:00+00,Sat 30 Oct 2021,2020,1456,1,3621459,3557074,240844,3862303,3797918,80.4894801917008,79.1477120336504,14
-856336.314876336,7036491.65084485,2021/07/21 23:00:00+00,Thu 22 Jul 2021,33546,15944,6937,2978225,2435203,196238,3174463,2631441,66.1550574250097,54.8386074953543,15
-856336.314876336,7036491.65084485,2021/04/13 23:00:00+00,Wed 14 Apr 2021,20353,6599,2,830028,354616,260,830288,354876,17.3030053647803,7.39553182971663,16
-856336.314876336,7036491.65084485,2021/10/30 23:00:00+00,Sun 31 Oct 2021,1598,1320,0,3623057,3558394,240844,3863901,3799238,80.5227821334041,79.175220521165,17
-856336.314876336,7036491.65084485,2021/07/22 23:00:00+00,Fri 23 Jul 2021,27089,20850,5616,3005314,2456053,201854,3207168,2657907,66.8366218827101,55.3901526700217,18
-856336.314876336,7036491.65084485,2021/04/14 23:00:00+00,Thu 15 Apr 2021,27114,10820,1,857142,365436,261,857403,365697,17.868075545809,7.62103890804642,19
-856336.314876336,7036491.65084485,2021/11/01 00:00:00+00,Mon 01 Nov 2021,291,297,2,3623348,3558691,240846,3864194,3799537,80.5288881840418,79.1814516103823,20
-856336.314876336,7036491.65084485,2021/07/23 23:00:00+00,Sat 24 Jul 2021,15447,14821,2276,3020761,2470874,204130,3224891,2675004,67.2059650071199,55.7464501026254,21
-856336.314876336,7036491.65084485,2021/04/15 23:00:00+00,Fri 16 Apr 2021,27968,9843,1,885110,375279,262,885372,375541,18.4509428846692,7.82618553766277,22
-856336.314876336,7036491.65084485,2021/11/02 00:00:00+00,Tue 02 Nov 2021,1101,1100,10,3624449,3559791,240856,3865305,3800647,80.5520411610332,79.2045837476105,23
-856336.314876336,7036491.65084485,2021/07/24 23:00:00+00,Sun 25 Jul 2021,14742,13654,1046,3035503,2484528,205176,3240679,2689704,67.534983189605,56.0527946226742,24
-856336.314876336,7036491.65084485,2021/04/16 23:00:00+00,Sat 17 Apr 2021,15857,4564,3,900967,379843,265,901232,380108,18.7814615301096,7.92136073651058,25
-856336.314876336,7036491.65084485,2021/11/03 00:00:00+00,Wed 03 Nov 2021,2538,1883,7,3626987,3561674,240863,3867850,3802537,80.6050783585519,79.2439709001882,26
-856336.314876336,7036491.65084485,2021/07/25 23:00:00+00,Mon 26 Jul 2021,23854,18321,3422,3059357,2502849,208598,3267955,2711447,68.10340857252,56.5059135954239,27
-856336.314876336,7036491.65084485,2021/04/17 23:00:00+00,Sun 18 Apr 2021,1081,487,0,902048,380330,265,902313,380595,18.803989314203,7.9315097012224,28
-856336.314876336,7036491.65084485,2021/07/26 23:00:00+00,Tue 27 Jul 2021,25529,23921,3672,3084886,2526770,212270,3297156,2739040,68.7119504997271,57.0809451832951,29
-856336.314876336,7036491.65084485,2021/11/04 00:00:00+00,Thu 04 Nov 2021,1536,1288,2,3628523,3562962,240865,3869388,3803827,80.637129914459,79.2708541948047,30
-856336.314876336,7036491.65084485,2021/04/18 23:00:00+00,Mon 19 Apr 2021,6757,2266,0,908805,382596,265,909070,382861,18.9448035946091,7.9787326047891,31
-856336.314876336,7036491.65084485,2021/07/27 23:00:00+00,Wed 28 Jul 2021,23450,25298,3265,3108336,2552068,215535,3323871,2767603,69.2686847754484,57.6761913415368,32
-856336.314876336,7036491.65084485,2021/07/28 23:00:00+00,Thu 29 Jul 2021,19295,27883,2962,3127631,2579951,218497,3346128,2798448,69.7325153865182,58.3189938395576,33
-856336.314876336,7036491.65084485,2021/04/19 23:00:00+00,Tue 20 Apr 2021,15097,7325,1,923902,389921,266,924168,390187,19.2594423404388,8.13140471049505,34
-856336.314876336,7036491.65084485,2021/11/05 00:00:00+00,Fri 05 Nov 2021,1631,1102,4,3630154,3564064,240869,3871023,3804933,80.6712029274032,79.2939029729798,35
-856336.314876336,7036491.65084485,2021/07/29 23:00:00+00,Fri 30 Jul 2021,21967,22959,2123,3149598,2602910,220620,3370218,2823530,70.2345452836594,58.8416967818612,36
-856336.314876336,7036491.65084485,2021/04/20 23:00:00+00,Wed 21 Apr 2021,26737,9897,4,950639,399818,270,950909,400088,19.8167184500051,8.33773920661771,37
-856336.314876336,7036491.65084485,2021/11/06 00:00:00+00,Sat 06 Nov 2021,1822,1362,6,3631976,3565426,240875,3872851,3806301,80.7092980146583,79.3224117691313,38
-856336.314876336,7036491.65084485,2021/07/30 23:00:00+00,Sat 31 Jul 2021,13757,12495,907,3163355,2615405,221527,3384882,2836932,70.5401395722305,59.1209912891874,39
-856336.314876336,7036491.65084485,2021/04/21 23:00:00+00,Thu 22 Apr 2021,31637,12191,1,982276,412009,271,982547,412280,20.4760468802979,8.59181760038879,40
-856336.314876336,7036491.65084485,2021/11/07 00:00:00+00,Sun 07 Nov 2021,698,775,0,3632674,3566201,240875,3873549,3807076,80.7238441694198,79.3385625856644,41
-856336.314876336,7036491.65084485,2021/07/31 23:00:00+00,Sun 01 Aug 2021,11144,9348,369,3174499,2624753,221896,3396395,2846649,70.7800677667422,59.3234912688686,42
-856336.314876336,7036491.65084485,2021/04/22 23:00:00+00,Fri 23 Apr 2021,33613,12362,3,1015889,424371,274,1016163,424645,21.176596362336,8.84950127320534,43
-856336.314876336,7036491.65084485,2021/08/01 23:00:00+00,Mon 02 Aug 2021,15035,16047,430,3189534,2640800,222326,3411860,2863126,71.1023547056915,59.6668680482457,44
-856336.314876336,7036491.65084485,2021/11/08 00:00:00+00,Mon 08 Nov 2021,516,535,4,3633190,3566736,240879,3874069,3807615,80.7346808463195,79.3497952180662,45
-856336.314876336,7036491.65084485,2021/04/23 23:00:00+00,Sat 24 Apr 2021,23709,7005,2,1039598,431376,276,1039874,431652,21.6707279891983,8.99552549442859,46
-856336.314876336,7036491.65084485,2021/11/09 00:00:00+00,Tue 09 Nov 2021,1373,1072,4,3634563,3567808,240883,3875446,3808691,80.7633772003404,79.3722188033433,47
-856336.314876336,7036491.65084485,2021/08/02 23:00:00+00,Tue 03 Aug 2021,17355,25462,1111,3206889,2666262,223437,3430326,2889699,71.4871817742099,60.2206430775829,48
-856336.314876336,7036491.65084485,2021/04/24 23:00:00+00,Sun 25 Apr 2021,9755,310,3,1049353,431686,279,1049632,431965,21.8740823991736,9.00204834033167,49
-856336.314876336,7036491.65084485,2021/11/10 00:00:00+00,Wed 10 Nov 2021,1602,1370,2,3636165,3569178,240885,3877050,3810063,80.7968041806232,79.4008109585478,50
-856336.314876336,7036491.65084485,2021/08/03 23:00:00+00,Wed 04 Aug 2021,22132,17317,1575,3229021,2683579,225012,3454033,2908591,71.9812300420192,60.6143478852538,51
-856336.314876336,7036491.65084485,2021/08/04 23:00:00+00,Thu 05 Aug 2021,13548,30062,1421,3242569,2713641,226433,3469002,2940074,72.2931804583873,61.2704461522399,52
-856336.314876336,7036491.65084485,2021/08/05 23:00:00+00,Fri 06 Aug 2021,12222,24755,949,3254791,2738396,227382,3482173,2965778,72.5676609803983,61.8061114272966,53
-856336.314876336,7036491.65084485,2021/08/06 23:00:00+00,Sat 07 Aug 2021,6343,8473,583,3261134,2746869,227965,3489099,2974834,72.7119971807968,61.9948363234573,54
-856336.314876336,7036491.65084485,2021/08/07 23:00:00+00,Sun 08 Aug 2021,8634,11990,153,3269768,2758859,228118,3497886,2986977,72.8951161806382,62.2478935688282,55
-856336.314876336,7036491.65084485,2021/08/08 23:00:00+00,Mon 09 Aug 2021,5558,23049,601,3275326,2781908,228719,3504045,3010627,73.0234682826097,62.7407539701312,56
-856336.314876336,7036491.65084485,2021/08/09 23:00:00+00,Tue 10 Aug 2021,9378,26025,717,3284704,2807933,229436,3514140,3037369,73.2338456928065,63.2980509194608,57
-856336.314876336,7036491.65084485,2021/08/10 23:00:00+00,Wed 11 Aug 2021,7028,31248,666,3291732,2839181,230102,3521834,3069283,73.3941868313953,63.9631311244157,58
-856336.314876336,7036491.65084485,2021/08/11 23:00:00+00,Thu 12 Aug 2021,6791,38309,865,3298523,2877490,230967,3529490,3108457,73.5537360589799,64.7795080107008,59
-856336.314876336,7036491.65084485,2021/08/12 23:00:00+00,Fri 13 Aug 2021,10944,28233,875,3309467,2905723,231842,3541309,3137565,73.8000412210517,65.3861118399239,60
-856336.314876336,7036491.65084485,2021/08/13 23:00:00+00,Sat 14 Aug 2021,18147,5857,281,3327614,2911580,232123,3559737,3143703,74.184076378566,65.5140263068668,61
-856336.314876336,7036491.65084485,2021/08/14 23:00:00+00,Sun 15 Aug 2021,17003,3740,52,3344617,2915320,232175,3576792,3147495,74.5394985411124,65.5930506891814,62
-856336.314876336,7036491.65084485,2021/08/15 23:00:00+00,Mon 16 Aug 2021,10201,23170,386,3354818,2938490,232561,3587379,3171051,74.7601291148373,66.0839521527371,63
-856336.314876336,7036491.65084485,2021/08/16 23:00:00+00,Tue 17 Aug 2021,12880,26875,530,3367698,2965365,233091,3600789,3198456,75.0395903402696,66.6550658651138,64
-856336.314876336,7036491.65084485,2021/08/17 23:00:00+00,Wed 18 Aug 2021,15245,25784,658,3382943,2991149,233749,3616692,3224898,75.3710050955305,67.2061108854628,65
-856336.314876336,7036491.65084485,2021/08/18 23:00:00+00,Thu 19 Aug 2021,11372,25734,545,3394315,3016883,234294,3628609,3251177,75.6193525544027,67.753759024399,66
-856336.314876336,7036491.65084485,2021/08/19 23:00:00+00,Fri 20 Aug 2021,14859,22277,686,3409174,3039160,234980,3644154,3274140,75.9433066744135,68.2323025083364,67
-856336.314876336,7036491.65084485,2021/08/20 23:00:00+00,Sat 21 Aug 2021,11904,7993,246,3421078,3047153,235226,3656304,3282379,76.1965097981273,68.4040013179066,68
-856336.314876336,7036491.65084485,2021/08/21 23:00:00+00,Sun 22 Aug 2021,8005,12261,162,3429083,3059414,235388,3664471,3294802,76.3667081447422,68.6628936969928,69
-856336.314876336,7036491.65084485,2021/08/22 23:00:00+00,Mon 23 Aug 2021,10882,15398,291,3439965,3074812,235679,3675644,3310491,76.5995508197425,68.9898487429142,70
-856336.314876336,7036491.65084485,2021/08/23 23:00:00+00,Tue 24 Aug 2021,9722,22933,384,3449687,3097745,236063,3685750,3333808,76.8101574673352,69.4757695030488,71
-856336.314876336,7036491.65084485,2021/08/24 23:00:00+00,Wed 25 Aug 2021,9426,19549,317,3459113,3117294,236380,3695493,3353674,77.0131992808614,69.8897722401433,72
-856336.314876336,7036491.65084485,2021/08/25 23:00:00+00,Thu 26 Aug 2021,8596,19454,369,3467709,3136748,236749,3704458,3373497,77.2000277585647,70.3028788674172,73
-856336.314876336,7036491.65084485,2021/08/26 23:00:00+00,Fri 27 Aug 2021,9732,19228,432,3477441,3155976,237181,3714622,3393157,77.411843112427,70.7125886132784,74
-856336.314876336,7036491.65084485,2021/08/27 23:00:00+00,Sat 28 Aug 2021,9934,7940,155,3487375,3163916,237336,3724711,3401252,77.6220954840441,70.8812864969379,75
-856336.314876336,7036491.65084485,2021/08/28 23:00:00+00,Sun 29 Aug 2021,8803,9199,30,3496178,3173115,237366,3733544,3410481,77.8061731129959,71.073616672144,76
-856336.314876336,7036491.65084485,2021/08/29 23:00:00+00,Mon 30 Aug 2021,5074,11158,85,3501252,3184273,237451,3738703,3421724,77.9136854516987,71.3079181305732,77
-856336.314876336,7036491.65084485,2021/08/30 23:00:00+00,Tue 31 Aug 2021,4077,12915,145,3505329,3197188,237596,3742925,3434784,78.0016709322189,71.5800854388614,78
-856336.314876336,7036491.65084485,2021/08/31 23:00:00+00,Wed 01 Sep 2021,4989,12557,184,3510318,3209745,237780,3748098,3447525,78.1094750276075,71.845604862667,79
-856336.314876336,7036491.65084485,2021/09/01 23:00:00+00,Thu 02 Sep 2021,5014,12379,249,3515332,3222124,238029,3753361,3460153,78.2191547016903,72.1087693932232,80
-856336.314876336,7036491.65084485,2021/09/02 23:00:00+00,Fri 03 Sep 2021,4784,16102,167,3520116,3238226,238196,3758312,3476422,78.3223323696332,72.4478115018405,81
-856336.314876336,7036491.65084485,2021/09/03 23:00:00+00,Sat 04 Sep 2021,4631,10592,136,3524747,3248818,238332,3763079,3487150,78.4216755211347,72.6713804821863,82
-856336.314876336,7036491.65084485,2021/09/04 23:00:00+00,Sun 05 Sep 2021,5310,11912,1,3530057,3260730,238333,3768390,3499063,78.5323555038544,72.9196445820054,83
-856336.314876336,7036491.65084485,2021/09/05 23:00:00+00,Mon 06 Sep 2021,2169,9699,76,3532226,3270429,238409,3770635,3508838,78.5791407723925,73.1233532679562,84
-856336.314876336,7036491.65084485,2021/09/06 23:00:00+00,Tue 07 Sep 2021,3036,10036,160,3535262,3280465,238569,3773831,3519034,78.645744655799,73.3358354942431,85
-856336.314876336,7036491.65084485,2021/09/07 23:00:00+00,Wed 08 Sep 2021,2614,14807,191,3537876,3295272,238760,3776636,3534032,78.7042001917675,73.648390263746,86
-856336.314876336,7036491.65084485,2021/09/08 23:00:00+00,Thu 09 Sep 2021,3129,14824,138,3541005,3310096,238898,3779903,3548994,78.7722836983661,73.9601948017711,87
-856336.314876336,7036491.65084485,2021/09/09 23:00:00+00,Fri 10 Sep 2021,3389,13951,116,3544394,3324047,239014,3783408,3563061,78.8453270686226,74.2533477516709,88
-856336.314876336,7036491.65084485,2021/09/10 23:00:00+00,Sat 11 Sep 2021,2564,11347,62,3546958,3335394,239076,3786034,3574470,78.900052286966,74.4911086108026,89
-856336.314876336,7036491.65084485,2021/09/11 23:00:00+00,Sun 12 Sep 2021,2043,12885,1,3549001,3348279,239077,3788078,3587356,78.9426487630871,74.7596498002821,90
-856336.314876336,7036491.65084485,2021/09/12 23:00:00+00,Mon 13 Sep 2021,1624,7752,52,3550625,3356031,239129,3789754,3595160,78.9775762063253,74.9222833128305,91
-856336.314876336,7036491.65084485,2021/09/13 23:00:00+00,Tue 14 Sep 2021,1556,10796,82,3552181,3366827,239211,3791392,3606038,79.0117117385593,75.1489782576666,92
-856336.314876336,7036491.65084485,2021/09/14 23:00:00+00,Wed 15 Sep 2021,3291,12381,138,3555472,3379208,239349,3794821,3618557,79.0831712868075,75.4098712540265,93
-856336.314876336,7036491.65084485,2021/09/15 23:00:00+00,Thu 16 Sep 2021,1919,10582,115,3557391,3389790,239464,3796855,3629254,79.1255593652958,75.632794201711,94
-856336.314876336,7036491.65084485,2021/09/16 23:00:00+00,Fri 17 Sep 2021,2563,14623,95,3559954,3404413,239559,3799513,3643972,79.1809514560638,75.9395138374986,95
-856336.314876336,7036491.65084485,2021/09/17 23:00:00+00,Sat 18 Sep 2021,2293,11242,48,3562247,3415655,239607,3801854,3655262,79.2297373418757,76.1747947648014,96
-856336.314876336,7036491.65084485,2021/09/18 23:00:00+00,Sun 19 Sep 2021,1864,8496,16,3564111,3424151,239623,3803734,3663774,79.2689160968207,76.3521828297439,97
-856336.314876336,7036491.65084485,2021/09/19 23:00:00+00,Mon 20 Sep 2021,965,5636,35,3565076,3429787,239658,3804734,3669445,79.2897558600893,76.4703651272403,98
-856336.314876336,7036491.65084485,2021/09/20 23:00:00+00,Tue 21 Sep 2021,1477,6681,90,3566553,3436468,239748,3806301,3676216,79.3224117691313,76.6114711643322,99
-856336.314876336,7036491.65084485,2021/09/21 23:00:00+00,Wed 22 Sep 2021,1902,8159,97,3568455,3444627,239845,3808300,3684472,79.3640704559052,76.7835242498779,100
-856336.314876336,7036491.65084485,2021/09/22 23:00:00+00,Thu 23 Sep 2021,1691,8741,89,3570146,3453368,239934,3810080,3693302,79.4011652345234,76.9675393595399,101
-856336.314876336,7036491.65084485,2021/09/23 23:00:00+00,Fri 24 Sep 2021,1914,7400,81,3572060,3460768,240015,3812075,3700783,79.4427405622443,77.1234416285525,102
-856336.314876336,7036491.65084485,2021/09/24 23:00:00+00,Sat 25 Sep 2021,2422,6609,53,3574482,3467377,240068,3814550,3707445,79.4943189763342,77.2622761314481,103
-856336.314876336,7036491.65084485,2021/09/25 23:00:00+00,Sun 26 Sep 2021,1549,7101,0,3576031,3474478,240068,3816099,3714546,79.5265997696373,77.4102592904186,104
-856336.314876336,7036491.65084485,2021/09/26 23:00:00+00,Mon 27 Sep 2021,1179,3833,45,3577210,3478311,240113,3817323,3718424,79.5521076398781,77.4910758923743,105
-856336.314876336,7036491.65084485,2021/09/27 23:00:00+00,Tue 28 Sep 2021,1455,5151,93,3578665,3483462,240206,3818871,3723668,79.5843675934179,77.600359610955,106
-856336.314876336,7036491.65084485,2021/09/28 23:00:00+00,Wed 29 Sep 2021,1654,3630,80,3580319,3487092,240286,3820605,3727378,79.6205037429257,77.6776751326816,107
-856336.314876336,7036491.65084485,2021/09/29 23:00:00+00,Thu 30 Sep 2021,1275,3988,78,3581594,3491080,240364,3821958,3731444,79.6486999426281,77.7624096101318,108
-856336.314876336,7036491.65084485,2021/09/30 23:00:00+00,Fri 01 Oct 2021,1871,5197,42,3583465,3496277,240406,3823871,3736683,79.688566409761,77.8715891298961,109
-856336.314876336,7036491.65084485,2021/10/01 23:00:00+00,Sat 02 Oct 2021,1684,4102,41,3585149,3500379,240447,3825596,3740826,79.7245150013994,77.957928269118,110
-856336.314876336,7036491.65084485,2021/10/02 23:00:00+00,Sun 03 Oct 2021,1197,3022,9,3586346,3503401,240456,3826802,3743857,79.7496477559013,78.0210935915852,111
-856336.314876336,7036491.65084485,2021/10/03 23:00:00+00,Mon 04 Oct 2021,348,1243,18,3586694,3504644,240474,3827168,3745118,79.7572751092577,78.047372533067,112
-856336.314876336,7036491.65084485,2021/10/04 23:00:00+00,Tue 05 Oct 2021,960,2837,70,3587654,3507481,240544,3828198,3748025,79.7787400654243,78.1079537248889,113
-856336.314876336,7036491.65084485,2021/10/05 23:00:00+00,Wed 06 Oct 2021,972,2583,40,3588626,3510064,240584,3829210,3750648,79.7998299058522,78.1626164239425,114
-856336.314876336,7036491.65084485,2021/10/06 23:00:00+00,Thu 07 Oct 2021,1213,2714,44,3589839,3512778,240628,3830467,3753406,79.8260254882809,78.2200924910373,115
-856336.314876336,7036491.65084485,2021/10/07 23:00:00+00,Fri 08 Oct 2021,916,2746,48,3590755,3515524,240676,3831431,3756200,79.8461150200718,78.2783187896099,116
-856336.314876336,7036491.65084485,2021/10/08 23:00:00+00,Sat 09 Oct 2021,724,2368,23,3591479,3517892,240699,3832178,3758591,79.8616823232335,78.3281466635852,117
-856336.314876336,7036491.65084485,2021/10/09 23:00:00+00,Sun 10 Oct 2021,1518,3927,2,3592997,3521819,240701,3833698,3762520,79.8933587634018,78.4100260934676,118
-856336.314876336,7036491.65084485,2021/10/10 23:00:00+00,Mon 11 Oct 2021,335,1140,19,3593332,3522959,240720,3834052,3763679,79.9007360395989,78.4341793790959,119
-856336.314876336,7036491.65084485,2021/10/11 23:00:00+00,Tue 12 Oct 2021,563,1626,21,3593895,3524585,240741,3834636,3765326,79.9129064613478,78.4685024691994,120
-856336.314876336,7036491.65084485,2021/10/12 23:00:00+00,Wed 13 Oct 2021,990,2082,11,3594885,3526667,240752,3835637,3767419,79.9337670643797,78.5121200937206,121
-856336.314876336,7036491.65084485,2021/10/13 23:00:00+00,Thu 14 Oct 2021,654,1612,9,3595539,3528279,240761,3836300,3769040,79.9475838274268,78.545901349979,122
-856336.314876336,7036491.65084485,2021/10/14 23:00:00+00,Fri 15 Oct 2021,957,2081,9,3596496,3530360,240770,3837266,3771130,79.9677150387442,78.5894564552105,123
-856336.314876336,7036491.65084485,2021/10/15 23:00:00+00,Sat 16 Oct 2021,1384,2653,14,3597880,3533013,240784,3838664,3773797,79.9968490277938,78.6450361038479,124
-856336.314876336,7036491.65084485,2021/10/16 23:00:00+00,Sun 17 Oct 2021,1706,2892,2,3599586,3535905,240786,3840372,3776691,80.0324433434566,78.7053463787473,125
-856336.314876336,7036491.65084485,2021/10/17 23:00:00+00,Mon 18 Oct 2021,679,1258,6,3600265,3537163,240792,3841057,3777955,80.0467185812956,78.7316878395188,126
-856336.314876336,7036491.65084485,2021/10/18 23:00:00+00,Tue 19 Oct 2021,1342,1810,13,3601607,3538973,240805,3842412,3779778,80.0749564605246,78.7696787279575,127
-856336.314876336,7036491.65084485,2021/10/19 23:00:00+00,Wed 20 Oct 2021,2263,2339,0,3603870,3541312,240805,3844675,3782117,80.1221168448015,78.8184229342428,128
-856336.314876336,7036491.65084485,2021/10/20 23:00:00+00,Thu 21 Oct 2021,1731,1857,11,3605601,3543169,240816,3846417,3783985,80.1584197124154,78.8573516120286,129
-856336.314876336,7036491.65084485,2021/10/21 23:00:00+00,Fri 22 Oct 2021,1508,1939,3,3607109,3545108,240819,3847928,3785927,80.1899085947143,78.8978224322963,130
-856336.314876336,7036491.65084485,2021/10/22 23:00:00+00,Sat 23 Oct 2021,2018,1708,1,3609127,3546816,240820,3849947,3787636,80.2319840767537,78.9334375877224,131
-856336.314876336,7036491.65084485,2021/10/23 23:00:00+00,Sun 24 Oct 2021,1957,2189,2,3611084,3549005,240822,3851906,3789827,80.2728091729969,78.9790975090439,132
-856336.314876336,7036491.65084485,2021/10/24 23:00:00+00,Mon 25 Oct 2021,1236,863,2,3612320,3549868,240824,3853144,3790692,80.2986087999235,78.9971239042713,133
-856336.314876336,7036491.65084485,2021/10/25 23:00:00+00,Tue 26 Oct 2021,1247,1237,6,3613567,3551105,240830,3854397,3791935,80.3247210232991,79.0230277300142,134
-856336.314876336,7036491.65084485,2021/04/25 23:00:00+00,Mon 26 Apr 2021,15601,3061,4,1064954,434747,283,1065237,435030,22.1992869049805,9.06592221475001,135
-856336.314876336,7036491.65084485,2021/04/26 23:00:00+00,Tue 27 Apr 2021,25922,7825,9,1090876,442572,292,1091168,442864,22.7396828062992,9.22918092019642,136
-856336.314876336,7036491.65084485,2021/04/27 23:00:00+00,Wed 28 Apr 2021,26047,8623,5,1116923,451195,297,1117220,451492,23.2826003189734,9.40898639767812,137
-856336.314876336,7036491.65084485,2021/04/28 23:00:00+00,Thu 29 Apr 2021,31697,11333,6,1148620,462528,303,1148923,462831,23.9432833338786,9.64528847338106,138
-856336.314876336,7036491.65084485,2021/11/11 00:00:00+00,Thu 11 Nov 2021,1394,1126,2,3637559,3570304,240887,3878446,3811191,80.8258964901462,79.4243182115148,139
-856336.314876336,7036491.65084485,2021/04/29 23:00:00+00,Fri 30 Apr 2021,36100,13544,8,1184720,476072,311,1185031,476383,24.6957655059822,9.92770894519747,140
-856336.314876336,7036491.65084485,2021/11/12 00:00:00+00,Fri 12 Nov 2021,1143,1162,6,3638702,3571466,240893,3879595,3812359,80.8498413781419,79.4486590550126,141
-856336.314876336,7036491.65084485,2021/04/30 23:00:00+00,Sat 01 May 2021,16612,6699,20,1201332,482771,331,1201663,483102,25.0423724486659,10.0677313145994,142
-856336.314876336,7036491.65084485,2021/11/13 00:00:00+00,Sat 13 Nov 2021,1396,1384,0,3640098,3572850,240893,3880991,3813743,80.8789336876649,79.4775012873764,143
-856336.314876336,7036491.65084485,2021/05/01 23:00:00+00,Sun 02 May 2021,12476,912,16,1213808,483683,347,1214155,484030,25.3027027714176,10.0870706149126,144
-856336.314876336,7036491.65084485,2021/11/14 00:00:00+00,Sun 14 Nov 2021,1647,1809,1,3641745,3574659,240894,3882639,3815553,80.9132776175316,79.5152212588926,145
-856336.314876336,7036491.65084485,2021/05/02 23:00:00+00,Mon 03 May 2021,14275,934,21,1228083,484617,368,1228451,484985,25.6006280271059,10.1069725888342,146
-856336.314876336,7036491.65084485,2021/05/03 23:00:00+00,Tue 04 May 2021,26666,6805,11,1254749,491422,379,1255128,491801,26.156570391823,10.2490164152731,147
-856336.314876336,7036491.65084485,2021/05/04 23:00:00+00,Wed 05 May 2021,32132,13467,70,1286881,504889,449,1287330,505338,26.8276524485992,10.5311242906405,148
-856336.314876336,7036491.65084485,2021/05/05 23:00:00+00,Thu 06 May 2021,37304,14385,133,1324185,519274,582,1324767,519856,27.6078306660868,10.8336759737744,149
-856336.314876336,7036491.65084485,2021/05/06 23:00:00+00,Fri 07 May 2021,40607,15092,98,1364792,534366,680,1365472,535046,28.4561132299362,11.1502319778248,150
-856336.314876336,7036491.65084485,2021/05/07 23:00:00+00,Sat 08 May 2021,25633,7067,10,1390425,541433,690,1391115,542123,28.9905072794335,11.2977149824769,151
-856336.314876336,7036491.65084485,2021/05/08 23:00:00+00,Sun 09 May 2021,19681,931,5,1410106,542364,695,1410801,543059,29.4007588591397,11.3172210008963,152
-856336.314876336,7036491.65084485,2021/05/09 23:00:00+00,Mon 10 May 2021,28861,4659,171,1438967,547023,866,1439833,547889,30.0057788663544,11.4178770574838,153
-856336.314876336,7036491.65084485,2021/05/10 23:00:00+00,Tue 11 May 2021,33928,14819,153,1472895,561842,1019,1473914,562861,30.7160188383124,11.7298899931416,154
-856336.314876336,7036491.65084485,2021/05/11 23:00:00+00,Wed 12 May 2021,31307,20932,175,1504202,582774,1194,1505396,583968,31.3720962655353,12.1697548764525,155
-856336.314876336,7036491.65084485,2021/05/12 23:00:00+00,Thu 13 May 2021,36013,25486,152,1540215,608260,1346,1541561,609606,32.1257663041451,12.7040447271335,156
-856336.314876336,7036491.65084485,2021/05/13 23:00:00+00,Fri 14 May 2021,38235,27954,237,1578450,636214,1583,1580033,637797,32.9275136766156,13.2915384934393,157
-856336.314876336,7036491.65084485,2021/05/14 23:00:00+00,Sat 15 May 2021,28882,12468,22,1607332,648682,1605,1608937,650287,33.529866194132,13.5518271366645,158
-856336.314876336,7036491.65084485,2021/05/15 23:00:00+00,Sun 16 May 2021,23189,1182,11,1630521,649864,1616,1632137,651480,34.0133487019641,13.5766889742439,159
-856336.314876336,7036491.65084485,2021/05/16 23:00:00+00,Mon 17 May 2021,35401,3960,120,1665922,653824,1736,1667658,655560,34.7535979330289,13.6617152083799,160
-856336.314876336,7036491.65084485,2021/05/17 23:00:00+00,Tue 18 May 2021,39026,12513,127,1704948,666337,1863,1706811,668200,35.5695371842854,13.9251298160953,161
-856336.314876336,7036491.65084485,2021/05/18 23:00:00+00,Wed 19 May 2021,37043,17606,211,1741991,683943,2074,1744065,686017,36.3459017250948,14.2964318782524,162
-856336.314876336,7036491.65084485,2021/05/19 23:00:00+00,Thu 20 May 2021,39102,19648,137,1781093,703591,2211,1783304,705802,37.1636331959923,14.7087465945222,163
-856336.314876336,7036491.65084485,2021/05/20 23:00:00+00,Fri 21 May 2021,25851,23259,14935,1806944,726850,17146,1824090,743996,38.0136037806665,15.5047005128041,164
-856336.314876336,7036491.65084485,2021/05/21 23:00:00+00,Sat 22 May 2021,16597,10259,13523,1823541,737109,30669,1854210,767778,38.6412974503175,16.0003117628585,165
-856336.314876336,7036491.65084485,2021/05/22 23:00:00+00,Sun 23 May 2021,8227,5536,10205,1831768,742645,40874,1872642,783519,39.0254159668848,16.3283504764699,166
-856336.314876336,7036491.65084485,2021/05/23 23:00:00+00,Mon 24 May 2021,22569,8240,8453,1854337,750885,49327,1903664,800212,39.6719071030041,16.6762286447131,167
-856336.314876336,7036491.65084485,2021/05/24 23:00:00+00,Tue 25 May 2021,30368,16516,3224,1884705,767401,52551,1937256,819952,40.3719564307237,17.0876055716357,168
-856336.314876336,7036491.65084485,2021/05/25 23:00:00+00,Wed 26 May 2021,19992,25477,3054,1904697,792878,55605,1960302,848483,40.8522296150125,17.6821848574529,169
-856336.314876336,7036491.65084485,2021/05/26 23:00:00+00,Thu 27 May 2021,17026,36057,550,1921723,828935,56155,1977878,885090,41.2185092942218,18.4450660714275,170
-856336.314876336,7036491.65084485,2021/05/27 23:00:00+00,Fri 28 May 2021,27059,31842,1562,1948782,860777,57717,2006499,918494,41.8149641587331,19.1411975236526,171
-856336.314876336,7036491.65084485,2021/05/28 23:00:00+00,Sat 29 May 2021,24502,7401,537,1973284,868178,58254,2031538,926432,42.3367709912162,19.306623564479,172
-856336.314876336,7036491.65084485,2021/05/29 23:00:00+00,Sun 30 May 2021,24262,1689,210,1997546,869867,58464,2056010,928331,42.846761677926,19.3461982749261,173
-856336.314876336,7036491.65084485,2021/05/30 23:00:00+00,Mon 31 May 2021,22610,7319,3445,2020156,877186,61909,2082065,939095,43.3897417098901,19.5705174867496,174
-856336.314876336,7036491.65084485,2021/05/31 23:00:00+00,Tue 01 Jun 2021,27610,11528,3654,2047766,888714,65563,2113329,954277,44.0412760687204,19.8869067726938,175
-856336.314876336,7036491.65084485,2021/06/01 23:00:00+00,Wed 02 Jun 2021,18722,20920,4008,2066488,909634,69571,2136059,979205,44.5149638878162,20.4064003914541,176
-856336.314876336,7036491.65084485,2021/06/02 23:00:00+00,Thu 03 Jun 2021,16703,30710,1978,2083191,940344,71549,2154740,1011893,44.9042715054374,21.0876105731789,177
-856336.314876336,7036491.65084485,2021/06/03 23:00:00+00,Fri 04 Jun 2021,29003,23350,153,2112194,963694,71702,2183896,1035396,45.5118756432974,21.5774075292814,178
-856336.314876336,7036491.65084485,2021/06/04 23:00:00+00,Sat 05 Jun 2021,20980,11503,35,2133174,975197,71737,2204911,1046934,45.9498232683876,21.8178567178748,179
-856336.314876336,7036491.65084485,2021/06/05 23:00:00+00,Sun 06 Jun 2021,19951,3918,47,2153125,979115,71784,2224909,1050899,46.3665768542336,21.9004863792349,180
-856336.314876336,7036491.65084485,2021/06/06 23:00:00+00,Mon 07 Jun 2021,19846,4607,47,2172971,983722,71831,2244802,1055553,46.7811422649363,21.9974746374871,181
-856336.314876336,7036491.65084485,2021/06/07 23:00:00+00,Tue 08 Jun 2021,26429,18348,48,2199400,1002070,71879,2271279,1073949,47.3329166769997,22.3808429225767,182
-856336.314876336,7036491.65084485,2021/06/08 23:00:00+00,Wed 09 Jun 2021,32821,20132,175,2232221,1022202,72054,2304275,1094256,48.0205455058113,22.8040359952727,183
-856336.314876336,7036491.65084485,2021/06/09 23:00:00+00,Thu 10 Jun 2021,27714,27509,273,2259935,1049711,72327,2332262,1122038,48.6037879604103,23.3830062984017,184
-856336.314876336,7036491.65084485,2021/06/10 23:00:00+00,Fri 11 Jun 2021,26460,32917,42,2286395,1082628,72369,2358764,1154997,49.1560833665554,24.0698640559723,185
-856336.314876336,7036491.65084485,2021/06/11 23:00:00+00,Sat 12 Jun 2021,12225,19733,105,2298620,1102361,72474,2371094,1174835,49.4130376476575,24.4832832796953,186
-856336.314876336,7036491.65084485,2021/06/12 23:00:00+00,Sun 13 Jun 2021,8558,18179,835,2307178,1120540,73309,2380487,1193849,49.6087855440397,24.8795305384849,187
-856336.314876336,7036491.65084485,2021/06/13 23:00:00+00,Mon 14 Jun 2021,16029,31318,52,2323207,1151858,73361,2396568,1225219,49.9439097771625,25.5332739122217,188
-856336.314876336,7036491.65084485,2021/06/14 23:00:00+00,Tue 15 Jun 2021,14713,41597,206,2337920,1193455,73567,2411487,1267022,50.2548182053671,26.40443853614,189
-856336.314876336,7036491.65084485,2021/06/15 23:00:00+00,Wed 16 Jun 2021,13486,48405,219,2351406,1241860,73786,2425192,1315646,50.5404271609636,27.4177511853136,190
-856336.314876336,7036491.65084485,2021/06/16 23:00:00+00,Thu 17 Jun 2021,21581,42701,535,2372987,1284561,74321,2447308,1358882,51.0013193654125,28.3187791899959,191
-856336.314876336,7036491.65084485,2021/06/17 23:00:00+00,Fri 18 Jun 2021,12024,50033,554,2385011,1334594,74875,2459886,1409469,51.2634419078053,29.3730002944659,192
-856336.314876336,7036491.65084485,2021/06/18 23:00:00+00,Sat 19 Jun 2021,6330,32820,434,2391341,1367414,75309,2466650,1442723,51.4044020665543,30.0660057822007,193
-856336.314876336,7036491.65084485,2021/06/19 23:00:00+00,Sun 20 Jun 2021,8524,26147,178,2399865,1393561,75487,2475352,1469048,51.5857496865179,30.6146125502473,194
-856336.314876336,7036491.65084485,2021/06/20 23:00:00+00,Mon 21 Jun 2021,15499,32348,575,2415364,1425909,76062,2491426,1501971,51.9207280412977,31.3007200763402,195
-856336.314876336,7036491.65084485,2021/06/21 23:00:00+00,Tue 22 Jun 2021,15153,43556,722,2430517,1469465,76784,2507301,1546249,52.2515592831872,32.2234631143484,196
-856336.314876336,7036491.65084485,2021/06/22 23:00:00+00,Wed 23 Jun 2021,20106,39410,884,2450623,1508875,77668,2528291,1586543,52.6889859141956,33.0631805354944,197
-856336.314876336,7036491.65084485,2021/06/23 23:00:00+00,Thu 24 Jun 2021,19033,44277,1032,2469656,1553152,78700,2548356,1631852,53.1071357641806,34.0074093694325,198
-856336.314876336,7036491.65084485,2021/06/24 23:00:00+00,Fri 25 Jun 2021,15222,50131,843,2484878,1603283,79543,2564421,1682826,53.441926561091,35.0696954622874,199
-856336.314876336,7036491.65084485,2021/06/25 23:00:00+00,Sat 26 Jun 2021,9073,30579,512,2493951,1633862,80055,2574006,1713917,53.6416756920208,35.7176245420723,200
-856336.314876336,7036491.65084485,2021/06/26 23:00:00+00,Sun 27 Jun 2021,8742,30485,59,2502693,1664347,80114,2582807,1744461,53.825086448548,36.3541542713491,201
-856336.314876336,7036491.65084485,2021/06/27 23:00:00+00,Mon 28 Jun 2021,24249,24667,527,2526942,1689014,80641,2607583,1769655,54.3414124232914,36.8791912671389,202
-856336.314876336,7036491.65084485,2021/06/28 23:00:00+00,Tue 29 Jun 2021,28152,31062,812,2555094,1720076,81453,2636547,1801529,54.9450153266039,37.543437881563,203
-856336.314876336,7036491.65084485,2021/06/29 23:00:00+00,Wed 30 Jun 2021,22587,36892,589,2577681,1756968,82042,2659723,1839010,55.4279976801176,38.3245330486344,204
-856336.314876336,7036491.65084485,2021/06/30 23:00:00+00,Thu 01 Jul 2021,15052,48310,643,2592733,1805278,82685,2675418,1887963,55.7550777646186,39.3447019799234,205
-856336.314876336,7036491.65084485,2021/07/01 23:00:00+00,Fri 02 Jul 2021,13694,47280,818,2606427,1852558,83503,2689930,1936061,56.0575044091729,40.3470529136177,206
-856336.314876336,7036491.65084485,2021/07/02 23:00:00+00,Sat 03 Jul 2021,9322,30488,506,2615749,1883046,84009,2699758,1967055,56.262317602577,40.9929605363655,207
-856336.314876336,7036491.65084485,2021/07/03 23:00:00+00,Sun 04 Jul 2021,6461,27786,233,2622210,1910832,84242,2706452,1995074,56.4018189778971,41.5768698633891,208
-856336.314876336,7036491.65084485,2021/07/04 23:00:00+00,Mon 05 Jul 2021,15631,33480,5342,2637841,1944312,89584,2727425,2033896,56.83889133293,42.3859111530037,209
-856336.314876336,7036491.65084485,2021/07/05 23:00:00+00,Tue 06 Jul 2021,12408,48307,5488,2650249,1992619,95072,2745321,2087691,57.2118397363853,43.5069862180394,210
-856336.314876336,7036491.65084485,2021/07/06 23:00:00+00,Wed 07 Jul 2021,19711,43774,5059,2669960,2036393,100131,2770091,2136524,57.7280406725492,44.5246543777361,211
-856336.314876336,7036491.65084485,2021/07/07 23:00:00+00,Thu 08 Jul 2021,17797,45612,5997,2687757,2082005,106128,2793885,2188133,58.2239019997628,45.6001737202666,212
-856336.314876336,7036491.65084485,2021/07/08 23:00:00+00,Fri 09 Jul 2021,13531,45101,6531,2701288,2127106,112659,2813947,2239765,58.641989330458,46.6761723773523,213
-856336.314876336,7036491.65084485,2021/07/09 23:00:00+00,Sat 10 Jul 2021,8645,23884,4365,2709933,2150990,117024,2826957,2268014,58.9131146505828,47.2648748499277,214
-856336.314876336,7036491.65084485,2021/07/10 23:00:00+00,Sun 11 Jul 2021,15243,16122,2153,2725176,2167112,119177,2844353,2286289,59.2756431724038,47.6457215236618,215
-856336.314876336,7036491.65084485,2021/07/11 23:00:00+00,Mon 12 Jul 2021,17126,31785,6092,2742302,2198897,125269,2867571,2324166,59.7595007959748,48.4350692369875,216
-856336.314876336,7036491.65084485,2021/07/12 23:00:00+00,Tue 13 Jul 2021,20119,36578,8490,2762421,2235475,133759,2896180,2369234,60.3557055833269,49.3742756879779,217
-856336.314876336,7036491.65084485,2021/07/13 23:00:00+00,Wed 14 Jul 2021,20805,35730,9335,2783226,2271205,143094,2926320,2414299,60.9838160482432,50.3134196196785,218
-856336.314876336,7036491.65084485,2021/07/14 23:00:00+00,Thu 15 Jul 2021,23660,28847,9585,2806886,2300052,152679,2959565,2452731,61.6766339781087,51.1143334016183,219
-856336.314876336,7036491.65084485,2021/07/15 23:00:00+00,Fri 16 Jul 2021,23520,27442,9168,2830406,2327494,161847,2992253,2489341,62.3578441598335,51.8772771348827,220
-856336.314876336,7036491.65084485,2021/07/16 23:00:00+00,Sat 17 Jul 2021,11520,19438,4677,2841926,2346932,166524,3008450,2513456,62.6953858054954,52.3798280261056,221
-856336.314876336,7036491.65084485,2022/05/17 23:00:00+00,Wed 18 May 2022,98,123,0,3849167,3798568,241048,4090215,4039616,85.2391123177797,84.1846411361505,222
-856336.314876336,7036491.65084485,2022/02/05 00:00:00+00,Sat 05 Feb 2022,1777,5750,0,3812253,3697233,241021,4053274,3938254,84.4692706228734,82.0722810517162,223
-856336.314876336,7036491.65084485,2022/05/18 23:00:00+00,Thu 19 May 2022,73,107,0,3849240,3798675,241048,4090288,4039723,85.2406336204983,84.1868709908203,224
-856336.314876336,7036491.65084485,2022/02/06 00:00:00+00,Sun 06 Feb 2022,1407,7555,0,3813660,3704788,241021,4054681,3945809,84.4985921697924,82.2297254632106,225
-856336.314876336,7036491.65084485,2022/05/19 23:00:00+00,Fri 20 May 2022,127,208,0,3849367,3798883,241048,4090415,4039931,85.2432802704334,84.1912056615802,226
-856336.314876336,7036491.65084485,2022/02/07 00:00:00+00,Mon 07 Feb 2022,439,1351,0,3814099,3706139,241021,4055120,3947160,84.5077408258673,82.2578799833865,227
-856336.314876336,7036491.65084485,2022/05/20 23:00:00+00,Sat 21 May 2022,392,762,0,3849759,3799645,241048,4090807,4040693,85.2514494576347,84.2070855611909,228
-856336.314876336,7036491.65084485,2022/02/08 00:00:00+00,Tue 08 Feb 2022,899,1238,0,3814998,3707377,241021,4056019,3948398,84.5264757730458,82.2836796103131,229
-856336.314876336,7036491.65084485,2022/05/21 23:00:00+00,Sun 22 May 2022,234,409,0,3849993,3800054,241048,4091041,4041102,85.2563259622396,84.2156090243677,230
-856336.314876336,7036491.65084485,2022/02/09 00:00:00+00,Wed 09 Feb 2022,1335,1784,0,3816333,3709161,241021,4057354,3950182,84.5542968570094,82.3208577479843,231
-856336.314876336,7036491.65084485,2022/05/22 23:00:00+00,Mon 23 May 2022,27,35,0,3850020,3800089,241048,4091068,4041137,85.2568886358478,84.2163384160821,232
-856336.314876336,7036491.65084485,2020/12/28 00:00:00+00,Mon 28 Dec 2020,267,16,2,267,16,2,269,18,0.00560589631926017,0.000375115738835253,233
-856336.314876336,7036491.65084485,2021/11/15 00:00:00+00,Mon 15 Nov 2021,1243,599,1,3642988,3575258,240895,3883883,3816153,80.9392022830377,79.5277251168538,234
-856336.314876336,7036491.65084485,2022/05/23 23:00:00+00,Tue 24 May 2022,64,83,0,3850084,3800172,241048,4091132,4041220,85.258222380697,84.2180681164334,235
-856336.314876336,7036491.65084485,2021/11/16 00:00:00+00,Tue 16 Nov 2021,1317,1081,5,3644305,3576339,240900,3885205,3817239,80.9667524500789,79.5503570997635,236
-856336.314876336,7036491.65084485,2022/05/24 23:00:00+00,Wed 25 May 2022,87,134,1,3850171,3800306,241049,4091220,4041355,85.2600562798647,84.2208814844747,237
-856336.314876336,7036491.65084485,2021/11/17 00:00:00+00,Wed 17 Nov 2021,1504,1123,3,3645809,3577462,240903,3886712,3818365,80.9981579733247,79.573822673204,238
-856336.314876336,7036491.65084485,2022/05/25 23:00:00+00,Thu 26 May 2022,98,155,0,3850269,3800461,241049,4091318,4041510,85.262098576665,84.2241116477813,239
-856336.314876336,7036491.65084485,2021/11/18 00:00:00+00,Thu 18 Nov 2021,1640,2512,5,3647449,3579974,240908,3888357,3820882,81.0324393839016,79.6262763573511,240
-856336.314876336,7036491.65084485,2022/05/26 23:00:00+00,Fri 27 May 2022,95,152,0,3850364,3800613,241049,4091413,4041662,85.2640783541755,84.2272792917982,241
-856336.314876336,7036491.65084485,2021/11/19 00:00:00+00,Fri 19 Nov 2021,1165,1559,0,3648614,3581533,240908,3889522,3822441,81.0567177081095,79.6587655482869,242
-856336.314876336,7036491.65084485,2022/05/27 23:00:00+00,Sat 28 May 2022,335,580,0,3850699,3801193,241049,4091748,4042242,85.2710596748705,84.239366354494,243
-856336.314876336,7036491.65084485,2022/05/28 23:00:00+00,Sun 29 May 2022,182,349,0,3850881,3801542,241049,4091930,4042591,85.2748525117854,84.2466394318747,244
-856336.314876336,7036491.65084485,2022/05/29 23:00:00+00,Mon 30 May 2022,8,23,0,3850889,3801565,241049,4091938,4042614,85.2750192298916,84.2471187464299,245
-856336.314876336,7036491.65084485,2022/05/30 23:00:00+00,Tue 31 May 2022,65,79,2,3850954,3801644,241051,4092005,4042695,85.2764154940306,84.2488067672546,246
-856336.314876336,7036491.65084485,2022/05/31 23:00:00+00,Wed 01 Jun 2022,70,102,0,3851024,3801746,241051,4092075,4042797,85.2778742774593,84.2509324231081,247
-856336.314876336,7036491.65084485,2022/06/01 23:00:00+00,Thu 02 Jun 2022,91,141,0,3851115,3801887,241051,4092166,4042938,85.2797706959168,84.2538708297289,248
-856336.314876336,7036491.65084485,2022/06/02 23:00:00+00,Fri 03 Jun 2022,60,143,0,3851175,3802030,241051,4092226,4043081,85.2810210817129,84.2568509158763,249
-856336.314876336,7036491.65084485,2022/06/03 23:00:00+00,Sat 04 Jun 2022,305,607,0,3851480,3802637,241051,4092531,4043688,85.2873772095099,84.2695006521804,250
-856336.314876336,7036491.65084485,2022/06/04 23:00:00+00,Sun 05 Jun 2022,143,273,0,3851623,3802910,241051,4092674,4043961,85.2903572956573,84.2751899075527,251
-856336.314876336,7036491.65084485,2022/06/05 23:00:00+00,Mon 06 Jun 2022,4,7,1,3851627,3802917,241052,4092679,4043969,85.2904614944736,84.2753566256589,252
-856336.314876336,7036491.65084485,2022/06/06 23:00:00+00,Tue 07 Jun 2022,29,52,0,3851656,3802969,241052,4092708,4044021,85.2910658476084,84.2764402933488,253
-856336.314876336,7036491.65084485,2022/06/07 23:00:00+00,Wed 08 Jun 2022,36,76,0,3851692,3803045,241052,4092744,4044097,85.2918160790861,84.2780241153573,254
-856336.314876336,7036491.65084485,2022/06/08 23:00:00+00,Thu 09 Jun 2022,73,122,0,3851765,3803167,241052,4092817,4044219,85.2933373818047,84.280566566476,255
-856336.314876336,7036491.65084485,2022/06/09 23:00:00+00,Fri 10 Jun 2022,56,108,0,3851821,3803275,241052,4092873,4044327,85.2945044085477,84.282817260909,256
-856336.314876336,7036491.65084485,2022/06/10 23:00:00+00,Sat 11 Jun 2022,189,562,0,3852010,3803837,241052,4093062,4044889,85.2984431238055,84.294529207866,257
-856336.314876336,7036491.65084485,2022/06/11 23:00:00+00,Sun 12 Jun 2022,143,288,0,3852153,3804125,241052,4093205,4045177,85.3014232099529,84.3005310596874,258
-856336.314876336,7036491.65084485,2022/06/12 23:00:00+00,Mon 13 Jun 2022,17,44,0,3852170,3804169,241052,4093222,4045221,85.3017774859285,84.3014480092712,259
-856336.314876336,7036491.65084485,2022/06/13 23:00:00+00,Tue 14 Jun 2022,37,55,0,3852207,3804224,241052,4093259,4045276,85.3025485571694,84.302594196251,260
-856336.314876336,7036491.65084485,2022/06/14 23:00:00+00,Wed 15 Jun 2022,66,123,0,3852273,3804347,241052,4093325,4045399,85.3039239815451,84.305157487133,261
-856336.314876336,7036491.65084485,2022/06/15 23:00:00+00,Thu 16 Jun 2022,42,85,0,3852315,3804432,241052,4093367,4045484,85.3047992516024,84.3069288670108,262
-856336.314876336,7036491.65084485,2022/06/16 23:00:00+00,Fri 17 Jun 2022,58,95,0,3852373,3804527,241052,4093425,4045579,85.306007957872,84.3089086445214,263
-856336.314876336,7036491.65084485,2022/06/17 23:00:00+00,Sat 18 Jun 2022,223,488,0,3852596,3805015,241052,4093648,4046067,85.3106552250809,84.3190784489964,264
-856336.314876336,7036491.65084485,2022/06/18 23:00:00+00,Sun 19 Jun 2022,80,129,0,3852676,3805144,241052,4093728,4046196,85.3123224061424,84.3217667784581,265
-856336.314876336,7036491.65084485,2022/06/19 23:00:00+00,Mon 20 Jun 2022,9,28,0,3852685,3805172,241052,4093737,4046224,85.3125099640118,84.3223502918296,266
-856336.314876336,7036491.65084485,2022/06/20 23:00:00+00,Tue 21 Jun 2022,74,169,1,3852759,3805341,241053,4093812,4046394,85.314072946257,84.3258930515853,267
-856336.314876336,7036491.65084485,2022/06/21 23:00:00+00,Wed 22 Jun 2022,60,94,0,3852819,3805435,241053,4093872,4046488,85.3153233320531,84.3278519893325,268
-856336.314876336,7036491.65084485,2022/06/22 23:00:00+00,Thu 23 Jun 2022,64,114,0,3852883,3805549,241053,4093936,4046602,85.3166570769023,84.3302277223452,269
-856336.314876336,7036491.65084485,2022/06/23 23:00:00+00,Fri 24 Jun 2022,55,93,1,3852938,3805642,241054,4093992,4046696,85.3178241036453,84.3321866600924,270
-856336.314876336,7036491.65084485,2022/06/24 23:00:00+00,Sat 25 Jun 2022,210,293,0,3853148,3805935,241054,4094202,4046989,85.3222004539317,84.3382927107301,271
-856336.314876336,7036491.65084485,2022/06/25 23:00:00+00,Sun 26 Jun 2022,174,402,0,3853322,3806337,241054,4094376,4047391,85.3258265727405,84.3466702955641,272
-856336.314876336,7036491.65084485,2022/06/26 23:00:00+00,Mon 27 Jun 2022,4,33,0,3853326,3806370,241054,4094380,4047424,85.3259099317935,84.347358007752,273
-856336.314876336,7036491.65084485,2022/06/27 23:00:00+00,Tue 28 Jun 2022,48,60,0,3853374,3806430,241054,4094428,4047484,85.3269102404304,84.3486083935481,274
-856336.314876336,7036491.65084485,2022/06/28 23:00:00+00,Wed 29 Jun 2022,63,81,3,3853437,3806511,241057,4094494,4047568,85.3282856648062,84.3503589336627,275
-856336.314876336,7036491.65084485,2022/06/29 23:00:00+00,Thu 30 Jun 2022,49,88,0,3853486,3806599,241057,4094543,4047656,85.3293068132063,84.3521928328303,276
-856336.314876336,7036491.65084485,2022/06/30 23:00:00+00,Fri 01 Jul 2022,46,65,0,3853532,3806664,241057,4094589,4047721,85.3302654423167,84.3535474174428,277
-856336.314876336,7036491.65084485,2022/07/01 23:00:00+00,Sat 02 Jul 2022,182,228,0,3853714,3806892,241057,4094771,4047949,85.3340582792316,84.358298883468,278
-856336.314876336,7036491.65084485,2022/07/02 23:00:00+00,Sun 03 Jul 2022,108,273,0,3853822,3807165,241057,4094879,4048222,85.3363089736646,84.3639881388403,279
-856336.314876336,7036491.65084485,2022/07/03 23:00:00+00,Mon 04 Jul 2022,14,15,0,3853836,3807180,241057,4094893,4048237,85.3366007303503,84.3643007352894,280
-856336.314876336,7036491.65084485,2022/07/04 23:00:00+00,Tue 05 Jul 2022,51,69,0,3853887,3807249,241057,4094944,4048306,85.337663558277,84.3657386789549,281
-856336.314876336,7036491.65084485,2022/07/05 23:00:00+00,Wed 06 Jul 2022,60,83,0,3853947,3807332,241057,4095004,4048389,85.3389139440732,84.3674683793062,282
-856336.314876336,7036491.65084485,2022/07/06 23:00:00+00,Thu 07 Jul 2022,76,77,0,3854023,3807409,241057,4095080,4048466,85.3404977660816,84.3690730410779,283
-856336.314876336,7036491.65084485,2022/07/07 23:00:00+00,Fri 08 Jul 2022,99,90,0,3854122,3807499,241057,4095179,4048556,85.3425609026452,84.3709486197721,284
-856336.314876336,7036491.65084485,2022/07/08 23:00:00+00,Sat 09 Jul 2022,119,143,0,3854241,3807642,241057,4095298,4048699,85.3450408344741,84.3739287059195,285
-856336.314876336,7036491.65084485,2022/07/09 23:00:00+00,Sun 10 Jul 2022,132,219,0,3854373,3807861,241057,4095430,4048918,85.3477916832256,84.3784926140753,286
-856336.314876336,7036491.65084485,2022/07/10 23:00:00+00,Mon 11 Jul 2022,11,16,0,3854384,3807877,241057,4095441,4048934,85.3480209206216,84.3788260502876,287
-856336.314876336,7036491.65084485,2022/07/11 23:00:00+00,Tue 12 Jul 2022,44,81,0,3854428,3807958,241057,4095485,4049015,85.3489378702054,84.3805140711124,288
-856336.314876336,7036491.65084485,2022/07/12 23:00:00+00,Wed 13 Jul 2022,99,74,0,3854527,3808032,241057,4095584,4049089,85.351001006769,84.3820562135942,289
-856336.314876336,7036491.65084485,2022/02/10 00:00:00+00,Thu 10 Feb 2022,686,2552,0,3817019,3711713,241021,4058040,3952734,84.5685929346117,82.3740408238459,290
-856336.314876336,7036491.65084485,2020/12/29 00:00:00+00,Tue 29 Dec 2020,80,3,0,347,19,2,349,21,0.00727307738075019,0.000437635028641129,291
-856336.314876336,7036491.65084485,2022/07/13 23:00:00+00,Thu 14 Jul 2022,71,39,0,3854598,3808071,241057,4095655,4049128,85.352480629961,84.3828689643617,292
-856336.314876336,7036491.65084485,2022/07/14 23:00:00+00,Fri 15 Jul 2022,80,118,1,3854678,3808189,241058,4095736,4049247,85.3541686507858,84.3853488961907,293
-856336.314876336,7036491.65084485,2022/07/15 23:00:00+00,Sat 16 Jul 2022,124,210,0,3854802,3808399,241058,4095860,4049457,85.3567527814311,84.3897252464771,294
-856336.314876336,7036491.65084485,2022/07/16 23:00:00+00,Sun 17 Jul 2022,119,165,0,3854921,3808564,241058,4095979,4049622,85.3592327132601,84.3931638074164,295
-856336.314876336,7036491.65084485,2022/07/17 23:00:00+00,Mon 18 Jul 2022,14,19,0,3854935,3808583,241058,4095993,4049641,85.3595244699458,84.3935597629185,296
-856336.314876336,7036491.65084485,2022/07/18 23:00:00+00,Tue 19 Jul 2022,30,33,0,3854965,3808616,241058,4096023,4049674,85.3601496628439,84.3942474751064,297
-856336.314876336,7036491.65084485,2022/07/19 23:00:00+00,Wed 20 Jul 2022,78,66,0,3855043,3808682,241058,4096101,4049740,85.3617751643788,84.3956228994821,298
-856336.314876336,7036491.65084485,2022/07/20 23:00:00+00,Thu 21 Jul 2022,52,30,0,3855095,3808712,241058,4096153,4049770,85.3628588320688,84.3962480923802,299
-856336.314876336,7036491.65084485,2022/07/21 23:00:00+00,Fri 22 Jul 2022,73,70,0,3855168,3808782,241058,4096226,4049840,85.3643801347874,84.397706875809,300
-856336.314876336,7036491.65084485,2022/07/22 23:00:00+00,Sat 23 Jul 2022,99,175,0,3855267,3808957,241058,4096325,4050015,85.366443271351,84.401353834381,301
-856336.314876336,7036491.65084485,2022/07/23 23:00:00+00,Sun 24 Jul 2022,108,231,0,3855375,3809188,241058,4096433,4050246,85.368693965784,84.406167819696,302
-856336.314876336,7036491.65084485,2022/07/24 23:00:00+00,Mon 25 Jul 2022,14,23,0,3855389,3809211,241058,4096447,4050269,85.3689857224698,84.4066471342512,303
-856336.314876336,7036491.65084485,2022/07/25 23:00:00+00,Tue 26 Jul 2022,18,16,0,3855407,3809227,241058,4096465,4050285,85.3693608382086,84.4069805704635,304
-856336.314876336,7036491.65084485,2022/07/26 23:00:00+00,Wed 27 Jul 2022,61,72,1,3855468,3809299,241059,4096527,4050358,85.3706529035313,84.4085018731821,305
-856336.314876336,7036491.65084485,2022/07/27 23:00:00+00,Thu 28 Jul 2022,49,71,0,3855517,3809370,241059,4096576,4050429,85.3716740519314,84.4099814963742,306
-856336.314876336,7036491.65084485,2022/07/28 23:00:00+00,Fri 29 Jul 2022,71,105,0,3855588,3809475,241059,4096647,4050534,85.3731536751235,84.4121696715174,307
-856336.314876336,7036491.65084485,2022/07/29 23:00:00+00,Sat 30 Jul 2022,100,119,0,3855688,3809594,241059,4096747,4050653,85.3752376514504,84.4146496033464,308
-856336.314876336,7036491.65084485,2022/07/30 23:00:00+00,Sun 31 Jul 2022,32,57,0,3855720,3809651,241059,4096779,4050710,85.375904523875,84.4158374698527,309
-856336.314876336,7036491.65084485,2022/07/31 23:00:00+00,Mon 01 Aug 2022,10,15,0,3855730,3809666,241059,4096789,4050725,85.3761129215077,84.4161500663017,310
-856336.314876336,7036491.65084485,2022/08/01 23:00:00+00,Tue 02 Aug 2022,36,28,0,3855766,3809694,241059,4096825,4050753,85.3768631529853,84.4167335796732,311
-856336.314876336,7036491.65084485,2022/08/02 23:00:00+00,Wed 03 Aug 2022,93,139,0,3855859,3809833,241059,4096918,4050892,85.3788012509693,84.4196303067676,312
-856336.314876336,7036491.65084485,2022/08/03 23:00:00+00,Thu 04 Aug 2022,45,52,0,3855904,3809885,241059,4096963,4050944,85.3797390403164,84.4207139744575,313
-856336.314876336,7036491.65084485,2022/08/04 23:00:00+00,Fri 05 Aug 2022,96,91,0,3856000,3809976,241059,4097059,4051035,85.3817396575902,84.422610392915,314
-856336.314876336,7036491.65084485,2022/08/05 23:00:00+00,Sat 06 Aug 2022,74,130,0,3856074,3810106,241059,4097133,4051165,85.3832818000721,84.4253195621399,315
-856336.314876336,7036491.65084485,2022/08/06 23:00:00+00,Sun 07 Aug 2022,28,80,0,3856102,3810186,241059,4097161,4051245,85.3838653134436,84.4269867432014,316
-856336.314876336,7036491.65084485,2022/08/07 23:00:00+00,Mon 08 Aug 2022,11,15,0,3856113,3810201,241059,4097172,4051260,85.3840945508395,84.4272993396504,317
-856336.314876336,7036491.65084485,2022/08/08 23:00:00+00,Tue 09 Aug 2022,47,42,0,3856160,3810243,241059,4097219,4051302,85.3850740197132,84.4281746097077,318
-856336.314876336,7036491.65084485,2022/08/09 23:00:00+00,Wed 10 Aug 2022,55,94,1,3856215,3810337,241060,4097275,4051397,85.3862410464562,84.4301543872182,319
-856336.314876336,7036491.65084485,2022/08/10 23:00:00+00,Thu 11 Aug 2022,45,40,0,3856260,3810377,241060,4097320,4051437,85.3871788358033,84.430987977749,320
-856336.314876336,7036491.65084485,2022/08/11 23:00:00+00,Fri 12 Aug 2022,70,75,0,3856330,3810452,241060,4097390,4051512,85.3886376192321,84.4325509599941,321
-856336.314876336,7036491.65084485,2022/08/12 23:00:00+00,Sat 13 Aug 2022,103,151,0,3856433,3810603,241060,4097493,4051663,85.3907841148488,84.4356977642477,322
-856336.314876336,7036491.65084485,2022/08/13 23:00:00+00,Sun 14 Aug 2022,17,26,0,3856450,3810629,241060,4097510,4051689,85.3911383908243,84.4362395980927,323
-856336.314876336,7036491.65084485,2022/08/14 23:00:00+00,Mon 15 Aug 2022,7,11,0,3856457,3810640,241060,4097517,4051700,85.3912842691672,84.4364688354886,324
-856336.314876336,7036491.65084485,2022/08/15 23:00:00+00,Tue 16 Aug 2022,41,28,0,3856498,3810668,241060,4097558,4051728,85.3921386994612,84.4370523488601,325
-856336.314876336,7036491.65084485,2022/08/16 23:00:00+00,Wed 17 Aug 2022,51,58,0,3856549,3810726,241060,4097609,4051786,85.3932015273879,84.4382610551297,326
-856336.314876336,7036491.65084485,2022/08/17 23:00:00+00,Thu 18 Aug 2022,55,39,0,3856604,3810765,241060,4097664,4051825,85.3943477143677,84.4390738058972,327
-856336.314876336,7036491.65084485,2022/08/18 23:00:00+00,Fri 19 Aug 2022,73,56,0,3856677,3810821,241060,4097737,4051881,85.3958690170863,84.4402408326402,328
-856336.314876336,7036491.65084485,2022/08/19 23:00:00+00,Sat 20 Aug 2022,108,127,0,3856785,3810948,241060,4097845,4052008,85.3981197115193,84.4428874825754,329
-856336.314876336,7036491.65084485,2022/08/20 23:00:00+00,Sun 21 Aug 2022,39,36,0,3856824,3810984,241060,4097884,4052044,85.3989324622868,84.443637714053,330
-856336.314876336,7036491.65084485,2022/08/21 23:00:00+00,Mon 22 Aug 2022,12,13,0,3856836,3810997,241060,4097896,4052057,85.399182539446,84.4439086309755,331
-856336.314876336,7036491.65084485,2022/08/22 23:00:00+00,Tue 23 Aug 2022,78,72,0,3856914,3811069,241060,4097974,4052129,85.400808040981,84.4454090939309,332
-856336.314876336,7036491.65084485,2022/08/23 23:00:00+00,Wed 24 Aug 2022,53,56,0,3856967,3811125,241060,4098027,4052185,85.4019125484342,84.4465761206739,333
-856336.314876336,7036491.65084485,2022/08/24 23:00:00+00,Thu 25 Aug 2022,40,49,0,3857007,3811174,241060,4098067,4052234,85.402746138965,84.4475972690741,334
-856336.314876336,7036491.65084485,2022/08/25 23:00:00+00,Fri 26 Aug 2022,98,89,0,3857105,3811263,241060,4098165,4052323,85.4047884357653,84.449452008005,335
-856336.314876336,7036491.65084485,2022/02/11 00:00:00+00,Fri 11 Feb 2022,546,4923,0,3817565,3716636,241021,4058586,3957657,84.5799714453564,82.4766349784173,336
-856336.314876336,7036491.65084485,2020/12/30 00:00:00+00,Wed 30 Dec 2020,1063,2,0,1410,21,2,1412,23,0.0294257457352987,0.000479314555178379,337
-856336.314876336,7036491.65084485,2021/11/20 00:00:00+00,Sat 20 Nov 2021,1547,2948,12,3650161,3584481,240920,3891081,3825401,81.0892068990453,79.720451247562,338
-856336.314876336,7036491.65084485,2022/02/12 00:00:00+00,Sat 12 Feb 2022,1397,5463,0,3818962,3722099,241021,4059983,3963120,84.6090845946426,82.5904826051538,339
-856336.314876336,7036491.65084485,2021/11/21 00:00:00+00,Sun 21 Nov 2021,1789,2770,0,3651950,3587251,240920,3892870,3828171,81.1264892355329,79.7781773918161,340
-856336.314876336,7036491.65084485,2020/12/31 00:00:00+00,Thu 31 Dec 2020,1039,1,0,2449,22,2,2451,24,0.0510782597714003,0.000500154318447004,341
-856336.314876336,7036491.65084485,2022/02/13 00:00:00+00,Sun 13 Feb 2022,1566,4706,0,3820528,3726805,241021,4061549,3967826,84.6417196639213,82.6885545310959,342
-856336.314876336,7036491.65084485,2021/11/22 00:00:00+00,Mon 22 Nov 2021,725,522,3,3652675,3587773,240923,3893598,3828696,81.1416605831924,79.7891182675321,343
-856336.314876336,7036491.65084485,2021/01/01 00:00:00+00,Fri 01 Jan 2021,820,0,0,3269,22,2,3271,24,0.0681668656516729,0.000500154318447004,344
-856336.314876336,7036491.65084485,2022/02/14 00:00:00+00,Mon 14 Feb 2022,174,954,0,3820702,3727759,241021,4061723,3968780,84.64534578273,82.7084356652542,345
-856336.314876336,7036491.65084485,2021/11/23 00:00:00+00,Tue 23 Nov 2021,2156,1600,8,3654831,3589373,240931,3895762,3830304,81.1867578309057,79.8226286068681,346
-856336.314876336,7036491.65084485,2021/01/02 00:00:00+00,Sat 02 Jan 2021,1020,0,0,4289,22,2,4291,24,0.0894234241856706,0.000500154318447004,347
-856336.314876336,7036491.65084485,2022/02/15 00:00:00+00,Tue 15 Feb 2022,649,818,1,3821351,3728577,241022,4062373,3969599,84.6588916288546,82.7255034313712,348
-856336.314876336,7036491.65084485,2021/11/24 00:00:00+00,Wed 24 Nov 2021,1615,3152,2,3656446,3592525,240933,3897379,3833458,81.2204557281111,79.8883572202173,349
-856336.314876336,7036491.65084485,2021/01/03 00:00:00+00,Sun 03 Jan 2021,24,3,1,4313,25,3,4316,28,0.0899444182673863,0.000583513371521505,350
-856336.314876336,7036491.65084485,2022/02/16 00:00:00+00,Wed 16 Feb 2022,798,1786,0,3822149,3730363,241022,4063171,3971385,84.675521759943,82.762723248569,351
-856336.314876336,7036491.65084485,2021/11/25 00:00:00+00,Thu 25 Nov 2021,982,1190,2,3657428,3593715,240935,3898363,3834650,81.2409620551674,79.9131982180335,352
-856336.314876336,7036491.65084485,2021/01/04 00:00:00+00,Mon 04 Jan 2021,1197,5,0,5510,30,3,5513,33,0.114889614899931,0.000687712187864631,353
-856336.314876336,7036491.65084485,2022/02/17 00:00:00+00,Thu 17 Feb 2022,790,1194,2,3822939,3731557,241024,4063963,3972581,84.6920268524518,82.7876476054383,354
-856336.314876336,7036491.65084485,2021/11/26 00:00:00+00,Fri 26 Nov 2021,1279,1113,12,3658707,3594828,240947,3899654,3835775,81.2678661895472,79.9366429517107,355
-856336.314876336,7036491.65084485,2021/01/05 00:00:00+00,Tue 05 Jan 2021,3543,14,0,9053,44,3,9056,47,0.18872489616067,0.000979468873625383,356
-856336.314876336,7036491.65084485,2022/02/18 00:00:00+00,Fri 18 Feb 2022,791,3295,0,3823730,3734852,241024,4064754,3975876,84.7085111051972,82.8563146254084,357
-856336.314876336,7036491.65084485,2022/08/26 23:00:00+00,Sat 27 Aug 2022,86,119,0,3857191,3811382,241060,4098251,4052442,85.4065806554064,84.4519319398339,358
-856336.314876336,7036491.65084485,2021/11/27 00:00:00+00,Sat 27 Nov 2021,1201,1567,6,3659908,3596395,240953,3900861,3837348,81.2930197838125,79.9694238993323,359
-856336.314876336,7036491.65084485,2021/01/06 00:00:00+00,Wed 06 Jan 2021,6790,14,0,15843,58,3,15846,61,0.330226888754635,0.00127122555938614,360
-856336.314876336,7036491.65084485,2022/02/19 00:00:00+00,Sat 19 Feb 2022,980,3555,0,3824710,3738407,241024,4065734,3979431,84.7289340732005,82.9303999838283,361
-856336.314876336,7036491.65084485,2022/08/27 23:00:00+00,Sun 28 Aug 2022,44,20,0,3857235,3811402,241060,4098295,4052462,85.4074976049902,84.4523487350993,362
-856336.314876336,7036491.65084485,2021/11/28 00:00:00+00,Sun 28 Nov 2021,1962,2262,1,3661870,3598657,240954,3902824,3839611,81.3339282391088,80.0165842836092,363
-856336.314876336,7036491.65084485,2021/11/29 00:00:00+00,Mon 29 Nov 2021,536,1000,2,3662406,3599657,240956,3903362,3840613,81.3451400317473,80.0374657264043,364
-856336.314876336,7036491.65084485,2021/11/30 00:00:00+00,Tue 30 Nov 2021,1895,1650,6,3664301,3601307,240962,3905263,3842269,81.384756421721,80.0719763743772,365
-856336.314876336,7036491.65084485,2021/12/01 00:00:00+00,Wed 01 Dec 2021,1070,1389,4,3665371,3602696,240966,3906337,3843662,81.4071383274715,80.1010061646104,366
-856336.314876336,7036491.65084485,2021/12/02 00:00:00+00,Thu 02 Dec 2021,1737,1416,0,3667108,3604112,240966,3908074,3845078,81.4433369962691,80.1305152693988,367
-856336.314876336,7036491.65084485,2021/12/03 00:00:00+00,Fri 03 Dec 2021,1016,1199,2,3668124,3605311,240968,3909092,3846279,81.4645518752765,80.1555438250844,368
-856336.314876336,7036491.65084485,2021/12/04 00:00:00+00,Sat 04 Dec 2021,1204,1702,1,3669328,3607013,240969,3910297,3847982,81.4896637900152,80.1910339419308,369
-856336.314876336,7036491.65084485,2021/12/05 00:00:00+00,Sun 05 Dec 2021,1348,1777,2,3670676,3608790,240971,3911647,3849761,81.5177974704279,80.2281078807857,370
-856336.314876336,7036491.65084485,2021/12/06 00:00:00+00,Mon 06 Dec 2021,936,1306,0,3671612,3610096,240971,3912583,3851067,81.5373034888473,80.2553246116145,371
-856336.314876336,7036491.65084485,2021/12/07 00:00:00+00,Tue 07 Dec 2021,483,748,2,3672095,3610844,240973,3913068,3851817,81.5474107740326,80.270954434066,372
-856336.314876336,7036491.65084485,2021/12/08 00:00:00+00,Wed 08 Dec 2021,794,1526,2,3672889,3612370,240975,3913864,3853345,81.5639992255944,80.3027975923405,373
-856336.314876336,7036491.65084485,2021/12/09 00:00:00+00,Thu 09 Dec 2021,785,1212,1,3673674,3613582,240976,3914650,3854558,81.5803792795235,80.3280762251853,374
-856336.314876336,7036491.65084485,2021/12/10 00:00:00+00,Fri 10 Dec 2021,895,1620,1,3674569,3615202,240977,3915546,3856179,81.5990517074122,80.3618574814437,375
-856336.314876336,7036491.65084485,2021/12/11 00:00:00+00,Sat 11 Dec 2021,643,845,2,3675212,3616047,240979,3916191,3857026,81.6124933547205,80.3795087609323,376
-856336.314876336,7036491.65084485,2021/12/12 00:00:00+00,Sun 12 Dec 2021,685,1193,0,3675897,3617240,240979,3916876,3858219,81.6267685925595,80.4043705985117,377
-856336.314876336,7036491.65084485,2021/12/13 00:00:00+00,Mon 13 Dec 2021,723,1071,1,3676620,3618311,240980,3917600,3859291,81.641856581166,80.4267108247357,378
-856336.314876336,7036491.65084485,2021/12/14 00:00:00+00,Tue 14 Dec 2021,633,1204,3,3677253,3619515,240983,3918236,3860498,81.6551106706048,80.451864419001,379
-856336.314876336,7036491.65084485,2021/12/15 00:00:00+00,Wed 15 Dec 2021,790,1258,1,3678043,3620773,240984,3919027,3861757,81.6715949233503,80.4781016809561,380
-856336.314876336,7036491.65084485,2021/12/16 00:00:00+00,Thu 16 Dec 2021,1049,1547,8,3679092,3622320,240992,3920084,3863312,81.6936225531252,80.5105075128389,381
-856336.314876336,7036491.65084485,2021/12/17 00:00:00+00,Fri 17 Dec 2021,1197,2459,1,3680289,3624779,240993,3921282,3865772,81.7185885895211,80.5617733304797,382
-856336.314876336,7036491.65084485,2021/12/18 00:00:00+00,Sat 18 Dec 2021,1251,1185,0,3681540,3625964,240993,3922533,3866957,81.7446591333701,80.586468449953,383
-856336.314876336,7036491.65084485,2021/12/19 00:00:00+00,Sun 19 Dec 2021,550,890,2,3682090,3626854,240995,3923085,3867849,81.7561626826944,80.6050575187886,384
-856336.314876336,7036491.65084485,2021/12/20 00:00:00+00,Mon 20 Dec 2021,516,620,1,3682606,3627474,240996,3923602,3868470,81.7669368403043,80.6179990117784,385
-856336.314876336,7036491.65084485,2021/12/21 00:00:00+00,Tue 21 Dec 2021,1406,1820,3,3684012,3629294,240999,3925011,3870293,81.7963000667498,80.6559899002171,386
-856336.314876336,7036491.65084485,2021/12/22 00:00:00+00,Wed 22 Dec 2021,1165,1601,2,3685177,3630895,241001,3926178,3871896,81.8206200704843,80.6893960407367,387
-856336.314876336,7036491.65084485,2021/12/23 00:00:00+00,Thu 23 Dec 2021,929,1401,0,3686106,3632296,241001,3927107,3873297,81.8399802105608,80.7185925490761,388
-856336.314876336,7036491.65084485,2021/12/24 00:00:00+00,Fri 24 Dec 2021,101,163,0,3686207,3632459,241001,3927208,3873460,81.8420850266509,80.7219894304889,389
-856336.314876336,7036491.65084485,2021/12/25 00:00:00+00,Sat 25 Dec 2021,1,7,0,3686208,3632466,241001,3927209,3873467,81.8421058664142,80.7221353088317,390
-856336.314876336,7036491.65084485,2021/12/26 00:00:00+00,Sun 26 Dec 2021,12,13,0,3686220,3632479,241001,3927221,3873480,81.8423559435734,80.7224062257542,391
-856336.314876336,7036491.65084485,2021/12/27 00:00:00+00,Mon 27 Dec 2021,391,590,0,3686611,3633069,241001,3927612,3874070,81.8505042910115,80.7347016860827,392
-856336.314876336,7036491.65084485,2021/12/28 00:00:00+00,Tue 28 Dec 2021,468,750,0,3687079,3633819,241001,3928080,3874820,81.8602573002212,80.7503315085342,393
-856336.314876336,7036491.65084485,2021/12/29 00:00:00+00,Wed 29 Dec 2021,1058,1312,0,3688137,3635131,241001,3929138,3876132,81.8823057697594,80.7776732779426,394
-856336.314876336,7036491.65084485,2021/12/30 00:00:00+00,Thu 30 Dec 2021,1051,1199,1,3689188,3636330,241002,3930190,3877332,81.904229200718,80.802680993865,395
-856336.314876336,7036491.65084485,2021/12/31 00:00:00+00,Fri 31 Dec 2021,713,1682,0,3689901,3638012,241002,3930903,3879014,81.9190879519285,80.8377334756828,396
-856336.314876336,7036491.65084485,2022/01/01 00:00:00+00,Sat 01 Jan 2022,69,100,0,3689970,3638112,241002,3930972,3879114,81.920525895594,80.8398174520097,397
-856336.314876336,7036491.65084485,2022/01/02 00:00:00+00,Sun 02 Jan 2022,271,629,0,3690241,3638741,241002,3931243,3879743,81.9261734714398,80.8529256631056,398
-856336.314876336,7036491.65084485,2022/01/03 00:00:00+00,Mon 03 Jan 2022,3632,728,1,3693873,3639469,241003,3934876,3880472,82.0018843313947,80.8681178505285,399
-856336.314876336,7036491.65084485,2022/01/04 00:00:00+00,Tue 04 Jan 2022,1187,785,1,3695060,3640254,241004,3936064,3881258,82.0266419701579,80.8844979044576,400
-856336.314876336,7036491.65084485,2022/01/05 00:00:00+00,Wed 05 Jan 2022,2139,913,0,3697199,3641167,241004,3938203,3882171,82.0712182237895,80.9035246083219,401
-856336.314876336,7036491.65084485,2022/01/06 00:00:00+00,Thu 06 Jan 2022,2455,1697,1,3699654,3642864,241005,3940659,3883869,82.1224006823772,80.938910526352,402
-856336.314876336,7036491.65084485,2022/01/07 00:00:00+00,Fri 07 Jan 2022,4854,782,2,3704508,3643646,241007,3945515,3884653,82.2235985728096,80.9552489007546,403
-856336.314876336,7036491.65084485,2022/01/08 00:00:00+00,Sat 08 Jan 2022,9789,744,2,3714297,3644390,241009,3955306,3885399,82.4276406949728,80.970795364153,404
-856336.314876336,7036491.65084485,2022/01/09 00:00:00+00,Sun 09 Jan 2022,7116,667,0,3721413,3645057,241009,3962422,3886066,82.5759364503923,80.9846954862532,405
-856336.314876336,7036491.65084485,2022/01/10 00:00:00+00,Mon 10 Jan 2022,6663,509,1,3728076,3645566,241010,3969086,3886576,82.7148126328144,80.9953237655202,406
-856336.314876336,7036491.65084485,2022/01/11 00:00:00+00,Tue 11 Jan 2022,4780,1369,1,3732856,3646935,241011,3973867,3887946,82.8144475410017,81.0238742411982,407
-856336.314876336,7036491.65084485,2022/01/12 00:00:00+00,Wed 12 Jan 2022,7559,927,1,3740415,3647862,241012,3981427,3888874,82.9719961513125,81.0432135415114,408
-856336.314876336,7036491.65084485,2022/01/13 00:00:00+00,Thu 13 Jan 2022,7321,817,0,3747736,3648679,241012,3988748,3889691,83.1245640582021,81.0602396281019,409
-856336.314876336,7036491.65084485,2022/01/14 00:00:00+00,Fri 14 Jan 2022,10723,835,0,3758459,3649514,241012,3999471,3890526,83.3480288397316,81.0776408304312,410
-856336.314876336,7036491.65084485,2022/01/15 00:00:00+00,Sat 15 Jan 2022,8363,652,2,3766822,3650166,241014,4007836,3891180,83.5223534594736,81.0912700356089,411
-856336.314876336,7036491.65084485,2022/01/16 00:00:00+00,Sun 16 Jan 2022,6965,1217,1,3773787,3651383,241015,4014802,3892398,83.6675232504029,81.1166528672701,412
-856336.314876336,7036491.65084485,2022/01/17 00:00:00+00,Mon 17 Jan 2022,2562,562,0,3776349,3651945,241015,4017364,3892960,83.7209147238971,81.1283648142271,413
-856336.314876336,7036491.65084485,2022/01/18 00:00:00+00,Tue 18 Jan 2022,4056,452,3,3780405,3652397,241018,4021423,3893415,83.8055033230044,81.1378469065143,414
-856336.314876336,7036491.65084485,2022/01/19 00:00:00+00,Wed 19 Jan 2022,3486,622,0,3783891,3653019,241018,4024909,3894037,83.8781507377589,81.1508092392674,415
-856336.314876336,7036491.65084485,2022/01/20 00:00:00+00,Thu 20 Jan 2022,3699,938,0,3787590,3653957,241018,4028608,3894975,83.9552370220895,81.1703569372133,416
-856336.314876336,7036491.65084485,2022/01/21 00:00:00+00,Fri 21 Jan 2022,3252,977,0,3790842,3654934,241018,4031860,3895952,84.0230079322391,81.1907173859268,417
-856336.314876336,7036491.65084485,2022/01/22 00:00:00+00,Sat 22 Jan 2022,4272,645,0,3795114,3655579,241018,4036132,3896597,84.1120354009227,81.204159033235,418
-856336.314876336,7036491.65084485,2022/01/23 00:00:00+00,Sun 23 Jan 2022,3094,680,0,3798208,3656259,241018,4039226,3897277,84.1765136284758,81.2183300722577,419
-856336.314876336,7036491.65084485,2022/01/24 00:00:00+00,Mon 24 Jan 2022,646,468,0,3798854,3656727,241018,4039872,3897745,84.1899761155473,81.2280830814674,420
-856336.314876336,7036491.65084485,2022/01/25 00:00:00+00,Tue 25 Jan 2022,692,1836,0,3799546,3658563,241018,4040564,3899581,84.2043972317292,81.2663448868286,421
-856336.314876336,7036491.65084485,2022/01/26 00:00:00+00,Wed 26 Jan 2022,700,897,0,3800246,3659460,241018,4041264,3900478,84.2189850660173,81.2850381544806,422
-856336.314876336,7036491.65084485,2022/01/27 00:00:00+00,Thu 27 Jan 2022,1274,1179,0,3801520,3660639,241018,4042538,3901657,84.2455349244215,81.3096082353743,423
-856336.314876336,7036491.65084485,2022/01/28 00:00:00+00,Fri 28 Jan 2022,1028,3095,1,3802548,3663734,241019,4043567,3904753,84.2669790408249,81.374128142454,424
-856336.314876336,7036491.65084485,2022/01/29 00:00:00+00,Sat 29 Jan 2022,2328,3445,0,3804876,3667179,241019,4045895,3908198,84.3154940097142,81.4459211269144,425
-856336.314876336,7036491.65084485,2022/01/30 00:00:00+00,Sun 30 Jan 2022,1639,7536,0,3806515,3674715,241019,4047534,3915734,84.3496503817115,81.6029695829067,426
-856336.314876336,7036491.65084485,2022/01/31 00:00:00+00,Mon 31 Jan 2022,481,1395,0,3806996,3676110,241019,4048015,3917129,84.3596743078437,81.6320410526665,427
-856336.314876336,7036491.65084485,2022/02/01 00:00:00+00,Tue 01 Feb 2022,749,3418,1,3807745,3679528,241020,4048765,3920548,84.3753041302952,81.7032922032819,428
-856336.314876336,7036491.65084485,2022/02/02 00:00:00+00,Wed 02 Feb 2022,651,2996,0,3808396,3682524,241020,4049416,3923544,84.3888708161831,81.7657281340347,429
-856336.314876336,7036491.65084485,2022/02/03 00:00:00+00,Thu 03 Feb 2022,907,2436,1,3809303,3684960,241021,4050324,3925981,84.407793321231,81.8165146371203,430
-856336.314876336,7036491.65084485,2022/02/04 00:00:00+00,Fri 04 Feb 2022,1173,6523,0,3810476,3691483,241021,4051497,3932504,84.4322383635451,81.9524524129216,431
-856336.314876336,7036491.65084485,2022/02/20 00:00:00+00,Sun 20 Feb 2022,1365,3588,0,3826075,3741995,241024,4067099,3983019,84.7573803500622,83.0051730544362,432
-856336.314876336,7036491.65084485,2022/02/21 00:00:00+00,Mon 21 Feb 2022,254,995,1,3826329,3742990,241025,4067354,3984015,84.7626944896957,83.0259294586517,433
-856336.314876336,7036491.65084485,2022/02/22 00:00:00+00,Tue 22 Feb 2022,476,981,1,3826805,3743971,241026,4067831,3984997,84.7726350567748,83.0463941061815,434
-856336.314876336,7036491.65084485,2022/08/28 23:00:00+00,Mon 29 Aug 2022,13,12,0,3857248,3811414,241060,4098308,4052474,85.4077685219127,84.4525988122585,435
-856336.314876336,7036491.65084485,2022/02/23 00:00:00+00,Wed 23 Feb 2022,829,1273,1,3827634,3745244,241027,4068661,3986271,84.7899320602878,83.0729439645857,436
-856336.314876336,7036491.65084485,2022/02/24 00:00:00+00,Thu 24 Feb 2022,655,1233,0,3828289,3746477,241027,4069316,3987504,84.8035821052287,83.0986393926959,437
-856336.314876336,7036491.65084485,2021/01/07 00:00:00+00,Thu 07 Jan 2021,11738,9,0,27581,67,3,27584,70,0.574844030001757,0.00145878342880376,438
-856336.314876336,7036491.65084485,2022/08/29 23:00:00+00,Tue 30 Aug 2022,41,44,0,3857289,3811458,241060,4098349,4052518,85.4086229522067,84.4535157618424,439
-856336.314876336,7036491.65084485,2022/02/25 00:00:00+00,Fri 25 Feb 2022,692,1228,0,3828981,3747705,241027,4070008,3988732,84.8180032214106,83.1242306219898,440
-856336.314876336,7036491.65084485,2021/01/08 00:00:00+00,Fri 08 Jan 2021,12687,6,0,40268,73,3,40271,76,0.839238106590804,0.00158382200841551,441
-856336.314876336,7036491.65084485,2022/08/30 23:00:00+00,Wed 31 Aug 2022,28,30,0,3857317,3811488,241060,4098377,4052548,85.4092064655782,84.4541409547404,442
-856336.314876336,7036491.65084485,2022/02/26 00:00:00+00,Sat 26 Feb 2022,960,2092,0,3829941,3749797,241027,4070968,3990824,84.8380093941485,83.1678274067478,443
-856336.314876336,7036491.65084485,2021/01/09 00:00:00+00,Sat 09 Jan 2021,8077,7,0,48345,80,3,48348,83,1.00756087451149,0.00172970035129589,444
-856336.314876336,7036491.65084485,2022/08/31 23:00:00+00,Thu 01 Sep 2022,33,29,0,3857350,3811517,241060,4098410,4052577,85.4098941777661,84.4547453078752,445
-856336.314876336,7036491.65084485,2022/02/27 00:00:00+00,Sun 27 Feb 2022,671,1783,0,3830612,3751580,241027,4071639,3992607,84.8519928753017,83.2049847046557,446
-856336.314876336,7036491.65084485,2021/01/10 00:00:00+00,Sun 10 Jan 2021,4787,5,1,53132,85,4,53136,89,1.10734166104167,0.00185473893090764,447
-856336.314876336,7036491.65084485,2022/09/01 23:00:00+00,Fri 02 Sep 2022,47,51,0,3857397,3811568,241060,4098457,4052628,85.4108736466397,84.4558081358019,448
-856336.314876336,7036491.65084485,2022/02/28 00:00:00+00,Mon 28 Feb 2022,81,433,0,3830693,3752013,241027,4071720,3993040,84.8536808961265,83.2140083221511,449
-856336.314876336,7036491.65084485,2021/01/11 00:00:00+00,Mon 11 Jan 2021,8349,8,0,61481,93,4,61485,97,1.28133284457142,0.00202145703705664,450
-856336.314876336,7036491.65084485,2022/09/02 23:00:00+00,Sat 03 Sep 2022,73,101,0,3857470,3811669,241060,4098530,4052729,85.4123949493583,84.457912951892,451
-856336.314876336,7036491.65084485,2022/03/01 00:00:00+00,Tue 01 Mar 2022,132,936,0,3830825,3752949,241027,4071852,3993976,84.856431744878,83.2335143405705,452
-856336.314876336,7036491.65084485,2021/01/12 00:00:00+00,Tue 12 Jan 2021,8897,14,0,70378,107,4,70382,111,1.46674421837238,0.00231321372281739,453
-856336.314876336,7036491.65084485,2022/09/03 23:00:00+00,Sun 04 Sep 2022,58,82,0,3857528,3811751,241060,4098588,4052811,85.4136036556279,84.4596218124801,454
-856336.314876336,7036491.65084485,2022/03/02 00:00:00+00,Wed 02 Mar 2022,206,997,2,3831031,3753946,241029,4072060,3994975,84.8607664156378,83.2543332640759,455
-856336.314876336,7036491.65084485,2021/01/13 00:00:00+00,Wed 13 Jan 2021,9899,4,0,80277,111,4,80281,115,1.6730370349685,0.0023965727758919,456
-856336.314876336,7036491.65084485,2022/09/04 23:00:00+00,Mon 05 Sep 2022,9,5,0,3857537,3811756,241060,4098597,4052816,85.4137912134973,84.4597260112964,457
-856336.314876336,7036491.65084485,2022/03/03 00:00:00+00,Thu 03 Mar 2022,278,1277,0,3831309,3755223,241029,4072338,3996252,84.8665598698265,83.2809456417699,458
-856336.314876336,7036491.65084485,2021/01/14 00:00:00+00,Thu 14 Jan 2021,8096,6,0,88373,117,4,88377,121,1.84175575839129,0.00252161135550365,459
-856336.314876336,7036491.65084485,2021/01/15 00:00:00+00,Fri 15 Jan 2021,7703,4,0,96076,121,4,96080,125,2.00228445484951,0.00260497040857815,460
-856336.314876336,7036491.65084485,2021/01/16 00:00:00+00,Sat 16 Jan 2021,5245,2,0,101321,123,4,101325,127,2.11158901319345,0.0026466499351154,461
-856336.314876336,7036491.65084485,2021/01/17 00:00:00+00,Sun 17 Jan 2021,1115,5,0,102436,128,4,102440,132,2.13482534923796,0.00275084875145852,462
-856336.314876336,7036491.65084485,2021/01/18 00:00:00+00,Mon 18 Jan 2021,8727,9,1,111163,137,5,111168,142,2.31671480304652,0.00295924638414477,463
-856336.314876336,7036491.65084485,2021/01/19 00:00:00+00,Tue 19 Jan 2021,8395,21,0,119558,158,5,119563,163,2.49166461568663,0.0033968814127859,464
-856336.314876336,7036491.65084485,2021/01/20 00:00:00+00,Wed 20 Jan 2021,8453,965,0,128011,1123,5,128016,1128,2.66782313459632,0.0235072529670092,465
-856336.314876336,7036491.65084485,2021/01/21 00:00:00+00,Thu 21 Jan 2021,9011,966,0,137022,2089,5,137027,2094,2.8556102414099,0.0436384642845011,466
-856336.314876336,7036491.65084485,2021/01/22 00:00:00+00,Fri 22 Jan 2021,6790,970,0,143812,3059,5,143817,3064,2.99711223400387,0.0638530346550675,467
-856336.314876336,7036491.65084485,2021/01/23 00:00:00+00,Sat 23 Jan 2021,4204,461,0,148016,3520,5,148021,3525,3.08472259878517,0.0734601655219037,468
-856336.314876336,7036491.65084485,2021/01/24 00:00:00+00,Sun 24 Jan 2021,1189,399,0,149205,3919,5,149210,3924,3.10950107731156,0.0817752310660852,469
-856336.314876336,7036491.65084485,2021/01/25 00:00:00+00,Mon 25 Jan 2021,1372,1293,0,150577,5212,5,150582,5217,3.13809323251612,0.108721044972418,470
-856336.314876336,7036491.65084485,2021/01/26 00:00:00+00,Tue 26 Jan 2021,1012,3507,0,151589,8719,5,151594,8724,3.15918307294396,0.181806094755486,471
-856336.314876336,7036491.65084485,2021/01/27 00:00:00+00,Wed 27 Jan 2021,2189,6708,0,153778,15427,5,153783,15432,3.20480131473898,0.321599226761424,472
-856336.314876336,7036491.65084485,2021/01/28 00:00:00+00,Thu 28 Jan 2021,1026,11545,0,154804,26972,5,154809,26977,3.22618291185259,0.562194293697701,473
-856336.314876336,7036491.65084485,2021/01/29 00:00:00+00,Fri 29 Jan 2021,1591,11526,0,156395,38498,5,156400,38503,3.25933897521298,0.802393405131875,474
-856336.314876336,7036491.65084485,2021/01/30 00:00:00+00,Sat 30 Jan 2021,655,7793,0,157050,46291,5,157055,46296,3.27298902015393,0.964797680284271,475
-856336.314876336,7036491.65084485,2021/01/31 00:00:00+00,Sun 31 Jan 2021,238,4086,0,157288,50377,5,157293,50382,3.27794888381186,1.04994895299987,476
-856336.314876336,7036491.65084485,2021/02/01 00:00:00+00,Mon 01 Feb 2021,1042,8333,1,158330,58710,6,158336,58716,3.29968475690104,1.2236275400806,477
-856336.314876336,7036491.65084485,2021/02/02 00:00:00+00,Tue 02 Feb 2021,844,5111,0,159174,63821,6,159180,63827,3.31727351709976,1.33013957014654,478
-856336.314876336,7036491.65084485,2021/02/03 00:00:00+00,Wed 03 Feb 2021,1415,6870,0,160589,70691,6,160595,70697,3.34676178212486,1.47330874380199,479
-856336.314876336,7036491.65084485,2021/02/04 00:00:00+00,Thu 04 Feb 2021,1455,10541,1,162044,81232,7,162051,81239,3.37710447744398,1.69300152817984,480
-856336.314876336,7036491.65084485,2021/02/05 00:00:00+00,Fri 05 Feb 2021,3404,8616,0,165448,89848,7,165455,89855,3.44804303161038,1.87255692850231,481
-856336.314876336,7036491.65084485,2021/02/06 00:00:00+00,Sat 06 Feb 2021,914,3870,0,166362,93718,7,166369,93725,3.4670905752379,1.95320681235189,482
-856336.314876336,7036491.65084485,2021/02/07 00:00:00+00,Sun 07 Feb 2021,338,1301,2,166700,95019,9,166709,95028,3.47417609474923,1.98036102389091,483
-856336.314876336,7036491.65084485,2021/02/08 00:00:00+00,Mon 08 Feb 2021,1200,881,0,167900,95900,9,167909,95909,3.49918381067158,1.99872085533057,484
-856336.314876336,7036491.65084485,2021/02/09 00:00:00+00,Tue 09 Feb 2021,4276,553,3,172176,96453,12,172188,96465,3.58835715769803,2.01030776370793,485
-856336.314876336,7036491.65084485,2021/02/10 00:00:00+00,Wed 10 Feb 2021,8832,584,0,181008,97037,12,181020,97049,3.77241394688653,2.0224781854568,486
-856336.314876336,7036491.65084485,2021/02/11 00:00:00+00,Thu 11 Feb 2021,6199,449,0,187207,97486,12,187219,97498,3.90159963938874,2.03183523916442,487
-856336.314876336,7036491.65084485,2021/02/12 00:00:00+00,Fri 12 Feb 2021,4401,527,0,191608,98013,12,191620,98025,3.99331543753396,2.04281779440698,488
-856336.314876336,7036491.65084485,2021/02/13 00:00:00+00,Sat 13 Feb 2021,1222,1918,0,192830,99931,12,192842,99943,4.01878162824822,2.08278846035621,489
-856336.314876336,7036491.65084485,2021/02/14 00:00:00+00,Sun 14 Feb 2021,2705,27,0,195535,99958,12,195547,99970,4.07515318788985,2.08335113396446,490
-856336.314876336,7036491.65084485,2021/02/15 00:00:00+00,Mon 15 Feb 2021,1970,7894,0,197505,107852,12,197517,107864,4.11620752152904,2.24786022520699,491
-856336.314876336,7036491.65084485,2021/02/16 00:00:00+00,Tue 16 Feb 2021,5658,8167,0,203163,116019,12,203175,116031,4.23411890210292,2.41805857182185,492
-856336.314876336,7036491.65084485,2021/02/17 00:00:00+00,Wed 17 Feb 2021,9757,8467,0,212920,124486,12,212932,124498,4.4374524723149,2.5945088474173,493
-856336.314876336,7036491.65084485,2021/02/18 00:00:00+00,Thu 18 Feb 2021,8473,8358,1,221393,132844,13,221406,132857,4.61404862625323,2.76870842857973,494
-856336.314876336,7036491.65084485,2021/02/19 00:00:00+00,Fri 19 Feb 2021,9400,6589,2,230793,139433,15,230808,139448,4.80998408050484,2.90606330828324,495
-856336.314876336,7036491.65084485,2021/02/20 00:00:00+00,Sat 20 Feb 2021,5900,3576,2,236693,143009,17,236710,143026,4.93298036331626,2.98062798125838,496
-856336.314876336,7036491.65084485,2021/02/21 00:00:00+00,Sun 21 Feb 2021,1117,1025,6,237810,144034,23,237833,144057,4.95638341746693,3.00211377718834,497
-856336.314876336,7036491.65084485,2021/02/22 00:00:00+00,Mon 22 Feb 2021,3954,1128,2,241764,145162,25,241789,145187,5.03882552095761,3.02566270968188,498
-856336.314876336,7036491.65084485,2021/02/23 00:00:00+00,Tue 23 Feb 2021,13371,1075,1,255135,146237,26,255161,146263,5.31749483538567,3.04808629495892,499
-856336.314876336,7036491.65084485,2021/02/24 00:00:00+00,Wed 24 Feb 2021,16951,2109,5,272086,148346,31,272117,148377,5.67085386136848,3.0921415545088,500
-856336.314876336,7036491.65084485,2021/02/25 00:00:00+00,Thu 25 Feb 2021,18107,1763,3,290193,150109,34,290227,150143,6.04826197416328,3.12894457644119,501
-856336.314876336,7036491.65084485,2021/02/26 00:00:00+00,Fri 26 Feb 2021,16092,2776,1,306285,152885,35,306320,152920,6.38363628444526,3.18681659903816,502
-856336.314876336,7036491.65084485,2021/02/27 00:00:00+00,Sat 27 Feb 2021,9008,706,1,315293,153591,36,315329,153627,6.57138171173231,3.20155031166908,503
-856336.314876336,7036491.65084485,2021/02/28 00:00:00+00,Sun 28 Feb 2021,2452,60,2,317745,153651,38,317783,153689,6.62252249079351,3.20284237699173,504
-856336.314876336,7036491.65084485,2021/03/01 00:00:00+00,Mon 01 Mar 2021,5613,806,0,323358,154457,38,323396,154495,6.73949608202031,3.21963922618625,505
-856336.314876336,7036491.65084485,2021/03/02 00:00:00+00,Tue 02 Mar 2021,12201,1617,0,335559,156074,38,335597,156112,6.9937620336608,3.25333712339161,506
-856336.314876336,7036491.65084485,2021/03/03 00:00:00+00,Wed 03 Mar 2021,12919,1511,1,348478,157585,39,348517,157624,7.26301177509144,3.28484684545377,507
-856336.314876336,7036491.65084485,2021/03/04 00:00:00+00,Thu 04 Mar 2021,18735,1697,5,367213,159282,44,367257,159326,7.65354893874548,3.32031612253697,508
-856336.314876336,7036491.65084485,2021/03/05 00:00:00+00,Fri 05 Mar 2021,18467,2403,6,385680,161685,50,385730,161735,8.03852188560679,3.37051911225109,509
-856336.314876336,7036491.65084485,2021/03/06 00:00:00+00,Sat 06 Mar 2021,10414,150,5,396094,161835,55,396149,161890,8.25565137910259,3.37374927555773,510
-856336.314876336,7036491.65084485,2021/03/07 00:00:00+00,Sun 07 Mar 2021,1537,14,3,397631,161849,58,397689,161907,8.28774461453628,3.3741035515333,511
-856336.314876336,7036491.65084485,2021/03/08 00:00:00+00,Mon 08 Mar 2021,6683,1514,5,404314,163363,63,404377,163426,8.42712095127684,3.40575915193834,512
-856336.314876336,7036491.65084485,2021/03/09 00:00:00+00,Tue 09 Mar 2021,13853,3116,6,418167,166479,69,418236,166548,8.71593923041672,3.47082089286299,513
-856336.314876336,7036491.65084485,2021/03/10 00:00:00+00,Wed 10 Mar 2021,13754,3999,3,431921,170478,72,431993,170550,9.00263185370319,3.55422162546402,514
-856336.314876336,7036491.65084485,2021/03/11 00:00:00+00,Thu 11 Mar 2021,18503,2109,4,450424,172587,76,450500,172663,9.38831335251564,3.59825604525063,515
-856336.314876336,7036491.65084485,2021/03/12 00:00:00+00,Fri 12 Mar 2021,17349,1348,4,467773,173935,80,467853,174015,9.74994576451609,3.62643140518981,516
-856336.314876336,7036491.65084485,2021/03/13 00:00:00+00,Sat 13 Mar 2021,8334,180,0,476107,174115,80,476187,174195,9.92362435159682,3.63018256257816,517
-856336.314876336,7036491.65084485,2021/03/14 00:00:00+00,Sun 14 Mar 2021,394,23,2,476501,174138,82,476583,174220,9.93187689785119,3.63070355665988,518
-856336.314876336,7036491.65084485,2021/03/15 00:00:00+00,Mon 15 Mar 2021,2674,1003,0,479175,175141,82,479257,175223,9.9876024248315,3.65160583921831,519
-856336.314876336,7036491.65084485,2021/03/16 00:00:00+00,Tue 16 Mar 2021,8970,3830,2,488145,178971,84,488229,179055,10.1745767808776,3.73146381206368,520
-856336.314876336,7036491.65084485,2021/03/17 00:00:00+00,Wed 17 Mar 2021,4897,2426,7,493042,181397,91,493133,181488,10.2767749799469,3.78216695609625,521
-856336.314876336,7036491.65084485,2021/03/18 00:00:00+00,Thu 18 Mar 2021,11745,4690,7,504787,186087,98,504885,186185,10.5216838778798,3.88005132416898,522
-856336.314876336,7036491.65084485,2021/03/19 00:00:00+00,Fri 19 Mar 2021,10392,6142,2,515179,192229,100,515279,192329,10.7382923772939,4.00809082969141,523
-856336.314876336,7036491.65084485,2021/03/20 00:00:00+00,Sat 20 Mar 2021,5259,3126,4,520438,195355,104,520542,195459,10.8479720513767,4.07331928872221,524
-856336.314876336,7036491.65084485,2021/03/21 00:00:00+00,Sun 21 Mar 2021,3654,59,3,524092,195414,107,524199,195521,10.92418306565,4.07461135404486,525
-856336.314876336,7036491.65084485,2021/03/22 00:00:00+00,Mon 22 Mar 2021,7429,2417,1,531521,197831,108,531629,197939,11.0790225067359,4.1250019016284,526
-856336.314876336,7036491.65084485,2021/03/23 00:00:00+00,Tue 23 Mar 2021,12579,7407,4,544100,205238,112,544212,205350,11.341249247945,4.27944538721218,527
-856336.314876336,7036491.65084485,2021/03/24 00:00:00+00,Wed 24 Mar 2021,13644,9785,2,557744,215023,114,557858,215137,11.6256286575087,4.48340415032221,528
-856336.314876336,7036491.65084485,2021/03/25 00:00:00+00,Thu 25 Mar 2021,20889,10230,3,578633,225253,117,578750,225370,12.0610129917168,4.69665744785006,529
-856336.314876336,7036491.65084485,2021/03/26 00:00:00+00,Fri 26 Mar 2021,19712,9507,1,598345,234760,118,598463,234878,12.4718272450312,4.89480191700814,530
-856336.314876336,7036491.65084485,2021/03/27 00:00:00+00,Sat 27 Mar 2021,11767,5362,3,610112,240122,121,610233,240243,12.7171112587029,5.00660724694432,531
-856336.314876336,7036491.65084485,2021/03/28 00:00:00+00,Sun 28 Mar 2021,2499,489,0,612611,240611,121,612732,240732,12.7691898271112,5.01679789118268,532
-856336.314876336,7036491.65084485,2021/03/28 23:00:00+00,Mon 29 Mar 2021,9289,3129,3,621900,243740,124,622024,243864,12.9628329074033,5.08206802974001,533
-856336.314876336,7036491.65084485,2021/03/29 23:00:00+00,Tue 30 Mar 2021,13348,8678,4,635248,252418,128,635376,252546,13.241085426566,5.26299885443821,534
-856336.314876336,7036491.65084485,2021/03/30 23:00:00+00,Wed 31 Mar 2021,15846,10508,4,651094,262926,132,651226,263058,13.5713956743737,5.482066445918,535
-856336.314876336,7036491.65084485,2021/03/31 23:00:00+00,Thu 01 Apr 2021,19720,11587,9,670814,274513,141,670955,274654,13.9825433639004,5.72372434078098,536
-856336.314876336,7036491.65084485,2021/04/01 23:00:00+00,Fri 02 Apr 2021,20161,13727,9,690975,288240,150,691125,288390,14.4028813890286,6.00997932903881,537
-856336.314876336,7036491.65084485,2021/04/02 23:00:00+00,Sat 03 Apr 2021,7556,4640,7,698531,292880,157,698688,293037,14.5604925186292,6.10682170894812,538
-856336.314876336,7036491.65084485,2021/04/03 23:00:00+00,Sun 04 Apr 2021,3046,172,3,701577,293052,160,701737,293212,14.6240329568352,6.11046866752012,539
-856336.314876336,7036491.65084485,2021/04/04 23:00:00+00,Mon 05 Apr 2021,3449,614,6,705026,293666,166,705192,293832,14.6960343389283,6.12338932074667,540
-856336.314876336,7036491.65084485,2021/04/05 23:00:00+00,Tue 06 Apr 2021,12010,8160,12,717036,301826,178,717214,302004,14.9465699729437,6.29369186617788,541
-856336.314876336,7036491.65084485,2021/04/06 23:00:00+00,Wed 07 Apr 2021,18379,10493,12,735415,312319,190,735605,312509,15.329834059217,6.51261357931478,542
-856336.314876336,7036491.65084485,2022/09/05 23:00:00+00,Tue 06 Sep 2022,42,22,0,3857579,3811778,241060,4098639,4052838,85.4146664835546,84.4601844860883,543
-856336.314876336,7036491.65084485,2022/09/06 23:00:00+00,Wed 07 Sep 2022,49,42,0,3857628,3811820,241060,4098688,4052880,85.4156876319548,84.4610597561456,544
-856336.314876336,7036491.65084485,2022/03/04 00:00:00+00,Fri 04 Mar 2022,735,1508,1,3832044,3756731,241030,4073074,3997761,84.8818979355922,83.3123928445422,545
-856336.314876336,7036491.65084485,2022/09/07 23:00:00+00,Thu 08 Sep 2022,39,49,2,3857667,3811869,241062,4098729,4052931,85.4165420622488,84.4621225840723,546
-856336.314876336,7036491.65084485,2022/09/08 23:00:00+00,Fri 09 Sep 2022,63,61,0,3857730,3811930,241062,4098792,4052992,85.4178549673347,84.4633938096317,547
-856336.314876336,7036491.65084485,2022/03/05 00:00:00+00,Sat 05 Mar 2022,962,3341,0,3833006,3760072,241030,4074036,4001102,84.9019457878566,83.3820184936227,548
-856336.314876336,7036491.65084485,2022/09/09 23:00:00+00,Sat 10 Sep 2022,94,135,0,3857824,3812065,241062,4098886,4053127,85.419813905082,84.4662071776729,549
-856336.314876336,7036491.65084485,2022/03/06 00:00:00+00,Sun 06 Mar 2022,455,1915,0,3833461,3761987,241030,4074491,4003017,84.9114278801438,83.4219266402821,550
-856336.314876336,7036491.65084485,2022/09/10 23:00:00+00,Sun 11 Sep 2022,58,58,0,3857882,3812123,241062,4098944,4053185,85.4210226113515,84.4674158839425,551
-856336.314876336,7036491.65084485,2022/03/07 00:00:00+00,Mon 07 Mar 2022,115,124,1,3833576,3762111,241031,4074607,4003142,84.913845292683,83.4245316106907,552
-856336.314876336,7036491.65084485,2022/09/11 23:00:00+00,Mon 12 Sep 2022,13,13,0,3857895,3812136,241062,4098957,4053198,85.421293528274,84.467686800865,553
-856336.314876336,7036491.65084485,2022/03/08 00:00:00+00,Tue 08 Mar 2022,120,493,0,3833696,3762604,241031,4074727,4003635,84.9163460642752,83.4348056139821,554
-856336.314876336,7036491.65084485,2022/03/09 00:00:00+00,Wed 09 Mar 2022,129,345,1,3833825,3762949,241032,4074857,4003981,84.9190552335002,83.4420161720731,555
-856336.314876336,7036491.65084485,2022/03/10 00:00:00+00,Thu 10 Mar 2022,259,508,0,3834084,3763457,241032,4075116,4004489,84.9244527321867,83.4526027718136,556
-856336.314876336,7036491.65084485,2022/03/11 00:00:00+00,Fri 11 Mar 2022,493,2182,0,3834577,3765639,241032,4075609,4006671,84.9347267354782,83.4980751352657,557
-856336.314876336,7036491.65084485,2022/03/12 00:00:00+00,Sat 12 Mar 2022,473,2391,2,3835050,3768030,241034,4076084,4009064,84.9446256230308,83.5479446887675,558
-856336.314876336,7036491.65084485,2022/03/13 00:00:00+00,Sun 13 Mar 2022,358,1082,0,3835408,3769112,241034,4076442,4010146,84.9520862582809,83.5704933126242,559
-856336.314876336,7036491.65084485,2022/03/14 00:00:00+00,Mon 14 Mar 2022,109,122,0,3835517,3769234,241034,4076551,4010268,84.9543577924772,83.5730357637429,560
-856336.314876336,7036491.65084485,2022/03/15 00:00:00+00,Tue 15 Mar 2022,222,755,1,3835739,3769989,241035,4076774,4011024,84.9590050596861,83.588790624774,561
-856336.314876336,7036491.65084485,2022/03/16 00:00:00+00,Wed 16 Mar 2022,195,798,0,3835934,3770787,241035,4076969,4011822,84.9630688135235,83.6054207558624,562
-856336.314876336,7036491.65084485,2022/03/18 00:00:00+00,Fri 18 Mar 2022,3,6,0,3835937,3770793,241035,4076972,4011828,84.9631313328133,83.605545794442,563
-856336.314876336,7036491.65084485,2022/03/19 00:00:00+00,Sat 19 Mar 2022,743,2778,0,3836680,3773571,241035,4077715,4014606,84.9786152769219,83.6634386568022,564
-856336.314876336,7036491.65084485,2022/03/20 00:00:00+00,Sun 20 Mar 2022,395,1402,0,3837075,3774973,241035,4078110,4016008,84.986846983413,83.6926560049048,565
-856336.314876336,7036491.65084485,2022/03/21 00:00:00+00,Mon 21 Mar 2022,56,112,0,3837131,3775085,241035,4078166,4016120,84.988014010156,83.6949900583909,566
-856336.314876336,7036491.65084485,2022/03/22 00:00:00+00,Tue 22 Mar 2022,141,576,0,3837272,3775661,241035,4078307,4016696,84.9909524167769,83.7069937620337,567
-856336.314876336,7036491.65084485,2022/03/23 00:00:00+00,Wed 23 Mar 2022,101,221,0,3837373,3775882,241035,4078408,4016917,84.9930572328671,83.711599349716,568
-856336.314876336,7036491.65084485,2022/03/24 00:00:00+00,Thu 24 Mar 2022,147,247,0,3837520,3776129,241035,4078555,4017164,84.9961206780675,83.7167467712434,569
-856336.314876336,7036491.65084485,2022/03/25 00:00:00+00,Fri 25 Mar 2022,435,1625,0,3837955,3777754,241035,4078990,4018789,85.0051859750894,83.7506113865549,570
-856336.314876336,7036491.65084485,2022/03/26 00:00:00+00,Sat 26 Mar 2022,874,1848,1,3838829,3779602,241036,4079865,4020638,85.0234207679494,83.7891441088386,571
-856336.314876336,7036491.65084485,2022/03/27 00:00:00+00,Sun 27 Mar 2022,380,803,0,3839209,3780405,241036,4080245,4021441,85.0313398779915,83.8058784387433,572
-856336.314876336,7036491.65084485,2022/03/27 23:00:00+00,Mon 28 Mar 2022,44,53,1,3839253,3780458,241037,4080290,4021495,85.0322776673386,83.8070037859598,573
-856336.314876336,7036491.65084485,2022/03/28 23:00:00+00,Tue 29 Mar 2022,137,193,3,3839390,3780651,241040,4080430,4021691,85.0351952341962,83.8110883795604,574
-856336.314876336,7036491.65084485,2022/03/29 23:00:00+00,Wed 30 Mar 2022,109,135,0,3839499,3780786,241040,4080539,4021826,85.0374667683925,83.8139017476017,575
-856336.314876336,7036491.65084485,2022/03/30 23:00:00+00,Thu 31 Mar 2022,227,360,0,3839726,3781146,241040,4080766,4022186,85.0421973946545,83.8214040623784,576
-856336.314876336,7036491.65084485,2022/03/31 23:00:00+00,Fri 01 Apr 2022,307,905,0,3840033,3782051,241040,4081073,4023091,85.0485952019779,83.8402640481365,577
-856336.314876336,7036491.65084485,2022/04/01 23:00:00+00,Sat 02 Apr 2022,729,1538,1,3840762,3783589,241041,4081803,4024630,85.063808229164,83.8723364438069,578
-856336.314876336,7036491.65084485,2022/04/02 23:00:00+00,Sun 03 Apr 2022,538,817,0,3841300,3784406,241041,4082341,4025447,85.0750200218026,83.8893625303974,579
-856336.314876336,7036491.65084485,2022/04/03 23:00:00+00,Mon 04 Apr 2022,50,52,0,3841350,3784458,241041,4082391,4025499,85.076062009966,83.8904461980874,580
-856336.314876336,7036491.65084485,2022/04/04 23:00:00+00,Tue 05 Apr 2022,131,169,0,3841481,3784627,241041,4082522,4025668,85.0787920189542,83.8939681180798,581
-856336.314876336,7036491.65084485,2022/04/05 23:00:00+00,Wed 06 Apr 2022,158,210,0,3841639,3784837,241041,4082680,4025878,85.0820847015506,83.8983444683662,582
-856336.314876336,7036491.65084485,2022/04/06 23:00:00+00,Thu 07 Apr 2022,117,178,0,3841756,3785015,241041,4082797,4026056,85.0845229538531,83.902053946228,583
-856336.314876336,7036491.65084485,2022/04/07 23:00:00+00,Fri 08 Apr 2022,256,422,2,3842012,3785437,241043,4083055,4026480,85.0898996127763,83.9108900058539,584
-856336.314876336,7036491.65084485,2022/04/08 23:00:00+00,Sat 09 Apr 2022,558,1018,0,3842570,3786455,241043,4083613,4027498,85.1015282006802,83.9321048848613,585
-856336.314876336,7036491.65084485,2022/04/09 23:00:00+00,Sun 10 Apr 2022,413,719,0,3842983,3787174,241043,4084026,4028217,85.1101350229102,83.9470886746515,586
-856336.314876336,7036491.65084485,2022/04/10 23:00:00+00,Mon 11 Apr 2022,70,93,1,3843053,3787267,241044,4084097,4028311,85.1116146461023,83.9490476123987,587
-856336.314876336,7036491.65084485,2022/04/11 23:00:00+00,Tue 12 Apr 2022,197,178,0,3843250,3787445,241044,4084294,4028489,85.1157200794662,83.9527570902605,588
-856336.314876336,7036491.65084485,2022/04/12 23:00:00+00,Wed 13 Apr 2022,142,235,0,3843392,3787680,241044,4084436,4028724,85.1186793258503,83.9576544346287,589
-856336.314876336,7036491.65084485,2022/04/13 23:00:00+00,Thu 14 Apr 2022,359,431,0,3843751,3788111,241044,4084795,4029155,85.1261608008638,83.9666363725975,590
-856336.314876336,7036491.65084485,2022/04/14 23:00:00+00,Fri 15 Apr 2022,446,990,0,3844197,3789101,241044,4085241,4030145,85.1354553352816,83.9872677382334,591
-856336.314876336,7036491.65084485,2022/04/15 23:00:00+00,Sat 16 Apr 2022,43,88,0,3844240,3789189,241044,4085284,4030233,85.1363514451021,83.989101637401,592
-856336.314876336,7036491.65084485,2022/04/16 23:00:00+00,Sun 17 Apr 2022,1,1,0,3844241,3789190,241044,4085285,4030234,85.1363722848654,83.9891224771643,593
-856336.314876336,7036491.65084485,2022/04/17 23:00:00+00,Mon 18 Apr 2022,36,62,1,3844277,3789252,241045,4085322,4030297,85.1371433561063,83.9904353822502,594
-856336.314876336,7036491.65084485,2022/04/18 23:00:00+00,Tue 19 Apr 2022,218,270,1,3844495,3789522,241046,4085541,4030568,85.1417072642622,83.996082958096,595
-856336.314876336,7036491.65084485,2022/04/19 23:00:00+00,Wed 20 Apr 2022,250,607,0,3844745,3790129,241046,4085791,4031175,85.1469172050793,84.0087326944001,596
-856336.314876336,7036491.65084485,2022/04/20 23:00:00+00,Thu 21 Apr 2022,170,236,0,3844915,3790365,241046,4085961,4031411,85.150459964835,84.0136508785315,597
-856336.314876336,7036491.65084485,2022/04/21 23:00:00+00,Fri 22 Apr 2022,195,254,0,3845110,3790619,241046,4086156,4031665,85.1545237186724,84.0189441784017,598
-856336.314876336,7036491.65084485,2022/04/22 23:00:00+00,Sat 23 Apr 2022,324,1010,0,3845434,3791629,241046,4086480,4032675,85.1612758019714,84.039992339303,599
-856336.314876336,7036491.65084485,2022/04/23 23:00:00+00,Sun 24 Apr 2022,181,252,0,3845615,3791881,241046,4086661,4032927,85.165047799123,84.0452439596467,600
-856336.314876336,7036491.65084485,2022/04/24 23:00:00+00,Mon 25 Apr 2022,41,59,1,3845656,3791940,241047,4086703,4032987,85.1659230691803,84.0464943454428,601
-856336.314876336,7036491.65084485,2022/04/25 23:00:00+00,Tue 26 Apr 2022,144,238,0,3845800,3792178,241047,4086847,4033225,85.168923995091,84.0514542091008,602
-856336.314876336,7036491.65084485,2022/04/26 23:00:00+00,Wed 27 Apr 2022,122,208,0,3845922,3792386,241047,4086969,4033433,85.1714664462097,84.0557888798606,603
-856336.314876336,7036491.65084485,2022/04/27 23:00:00+00,Thu 28 Apr 2022,100,130,0,3846022,3792516,241047,4087069,4033563,85.1735504225366,84.0584980490856,604
-856336.314876336,7036491.65084485,2022/04/28 23:00:00+00,Fri 29 Apr 2022,168,222,0,3846190,3792738,241047,4087237,4033785,85.1770515027657,84.0631244765312,605
-856336.314876336,7036491.65084485,2022/04/29 23:00:00+00,Sat 30 Apr 2022,281,723,0,3846471,3793461,241047,4087518,4034508,85.1829074762442,84.0781916253744,606
-856336.314876336,7036491.65084485,2022/04/30 23:00:00+00,Sun 01 May 2022,187,747,0,3846658,3794208,241047,4087705,4035255,85.1868045119755,84.0937589285361,607
-856336.314876336,7036491.65084485,2022/05/01 23:00:00+00,Mon 02 May 2022,12,26,0,3846670,3794234,241047,4087717,4035281,85.1870545891347,84.0943007623811,608
-856336.314876336,7036491.65084485,2022/05/02 23:00:00+00,Tue 03 May 2022,96,119,0,3846766,3794353,241047,4087813,4035400,85.1890552064085,84.09678069421,609
-856336.314876336,7036491.65084485,2022/05/03 23:00:00+00,Wed 04 May 2022,113,128,0,3846879,3794481,241047,4087926,4035528,85.1914100996578,84.0994481839084,610
-856336.314876336,7036491.65084485,2022/05/04 23:00:00+00,Thu 05 May 2022,112,165,0,3846991,3794646,241047,4088038,4035693,85.1937441531439,84.1028867448477,611
-856336.314876336,7036491.65084485,2022/05/05 23:00:00+00,Fri 06 May 2022,138,257,0,3847129,3794903,241047,4088176,4035950,85.196620040475,84.1082425640078,612
-856336.314876336,7036491.65084485,2022/05/06 23:00:00+00,Sat 07 May 2022,441,1088,0,3847570,3795991,241047,4088617,4037038,85.2058103760765,84.130916226444,613
-856336.314876336,7036491.65084485,2022/05/07 23:00:00+00,Sun 08 May 2022,274,437,0,3847844,3796428,241047,4088891,4037475,85.2115204712121,84.1400232029924,614
-856336.314876336,7036491.65084485,2022/05/08 23:00:00+00,Mon 09 May 2022,24,32,0,3847868,3796460,241047,4088915,4037507,85.2120206255305,84.140690075417,615
-856336.314876336,7036491.65084485,2022/05/09 23:00:00+00,Tue 10 May 2022,80,98,1,3847948,3796558,241048,4088996,4037606,85.2137086463553,84.1427532119806,616
-856336.314876336,7036491.65084485,2022/05/10 23:00:00+00,Wed 11 May 2022,112,132,0,3848060,3796690,241048,4089108,4037738,85.2160426998413,84.1455040607321,617
-856336.314876336,7036491.65084485,2022/05/11 23:00:00+00,Thu 12 May 2022,207,398,0,3848267,3797088,241048,4089315,4038136,85.2203565308379,84.153798286513,618
-856336.314876336,7036491.65084485,2022/05/12 23:00:00+00,Fri 13 May 2022,173,327,0,3848440,3797415,241048,4089488,4038463,85.2239618098834,84.1606128891018,619
-856336.314876336,7036491.65084485,2022/05/13 23:00:00+00,Sat 14 May 2022,333,633,0,3848773,3798048,241048,4089821,4039096,85.2309014510519,84.1738044592509,620
-856336.314876336,7036491.65084485,2022/05/14 23:00:00+00,Sun 15 May 2022,168,254,0,3848941,3798302,241048,4089989,4039350,85.234402531281,84.1790977591211,621
-856336.314876336,7036491.65084485,2022/05/15 23:00:00+00,Mon 16 May 2022,31,41,0,3848972,3798343,241048,4090020,4039391,85.2350485639423,84.1799521894151,622
-856336.314876336,7036491.65084485,2022/05/16 23:00:00+00,Tue 17 May 2022,97,102,0,3849069,3798445,241048,4090117,4039493,85.2370700209794,84.1820778452685,623
-856336.314876336,7036491.65084485,2022/09/12 23:00:00+00,Tue 13 Sep 2022,29,25,0,3857924,3812161,241062,4098986,4053223,85.4218978814088,84.4682077949467,624
-856336.314876336,7036491.65084485,2022/09/13 23:00:00+00,Wed 14 Sep 2022,36,33,0,3857960,3812194,241062,4099022,4053256,85.4226481128865,84.4688955071346,625
-856336.314876336,7036491.65084485,2022/09/14 23:00:00+00,Thu 15 Sep 2022,50,35,0,3858010,3812229,241062,4099072,4053291,85.4236901010499,84.469624898849,626
-856336.314876336,7036491.65084485,2022/09/15 23:00:00+00,Fri 16 Sep 2022,38,56,0,3858048,3812285,241062,4099110,4053347,85.4244820120541,84.470791925592,627
-856336.314876336,7036491.65084485,2022/09/16 23:00:00+00,Sat 17 Sep 2022,67,149,0,3858115,3812434,241062,4099177,4053496,85.4258782761931,84.4738970503191,628
-856336.314876336,7036491.65084485,2022/09/17 23:00:00+00,Sun 18 Sep 2022,30,53,0,3858145,3812487,241062,4099207,4053549,85.4265034690912,84.4750015577723,629
-856336.314876336,7036491.65084485,2022/09/18 23:00:00+00,Mon 19 Sep 2022,11,11,0,3858156,3812498,241062,4099218,4053560,85.4267327064872,84.4752307951683,630
-856336.314876336,7036491.65084485,2022/09/19 23:00:00+00,Tue 20 Sep 2022,39,37,0,3858195,3812535,241062,4099257,4053597,85.4275454572546,84.4760018664092,631
-856336.314876336,7036491.65084485,2022/09/20 23:00:00+00,Wed 21 Sep 2022,41,32,0,3858236,3812567,241062,4099298,4053629,85.4283998875486,84.4766687388338,632
-856336.314876336,7036491.65084485,2022/09/21 23:00:00+00,Thu 22 Sep 2022,61,34,0,3858297,3812601,241062,4099359,4053663,85.429671113108,84.4773772907849,633
-856336.314876336,7036491.65084485,2022/09/22 23:00:00+00,Fri 23 Sep 2022,38,39,0,3858335,3812640,241062,4099397,4053702,85.4304630241122,84.4781900415524,634
-856336.314876336,7036491.65084485,2022/09/23 23:00:00+00,Sat 24 Sep 2022,56,104,0,3858391,3812744,241062,4099453,4053806,85.4316300508553,84.4803573769323,635
-856336.314876336,7036491.65084485,2022/09/24 23:00:00+00,Sun 25 Sep 2022,42,74,0,3858433,3812818,241062,4099495,4053880,85.4325053209126,84.4818995194142,636
-856336.314876336,7036491.65084485,2022/09/25 23:00:00+00,Mon 26 Sep 2022,23,10,0,3858456,3812828,241062,4099518,4053890,85.4329846354677,84.4821079170469,637
-856336.314876336,7036491.65084485,2022/09/26 23:00:00+00,Tue 27 Sep 2022,30,33,2,3858486,3812861,241064,4099550,4053925,85.4336515078923,84.4828373087613,638
-856336.314876336,7036491.65084485,2022/09/27 23:00:00+00,Wed 28 Sep 2022,43,27,0,3858529,3812888,241064,4099593,4053952,85.4345476177129,84.4833999823696,639
-856336.314876336,7036491.65084485,2022/09/28 23:00:00+00,Thu 29 Sep 2022,31,23,0,3858560,3812911,241064,4099624,4053975,85.4351936503742,84.4838792969247,640
-856336.314876336,7036491.65084485,2022/09/29 23:00:00+00,Fri 30 Sep 2022,39,58,0,3858599,3812969,241064,4099663,4054033,85.4360064011417,84.4850880031943,641
-856336.314876336,7036491.65084485,2022/09/30 23:00:00+00,Sat 01 Oct 2022,51,106,0,3858650,3813075,241064,4099714,4054139,85.4370692290684,84.4872970181008,642
-856336.314876336,7036491.65084485,2022/10/01 23:00:00+00,Sun 02 Oct 2022,26,47,0,3858676,3813122,241064,4099740,4054186,85.4376110629134,84.4882764869744,643
-856336.314876336,7036491.65084485,2022/10/02 23:00:00+00,Mon 03 Oct 2022,24,1,0,3858700,3813123,241064,4099764,4054187,85.4381112172318,84.4882973267377,644
-856336.314876336,7036491.65084485,2022/10/03 23:00:00+00,Tue 04 Oct 2022,31,17,0,3858731,3813140,241064,4099795,4054204,85.4387572498931,84.4886516027132,645
-856336.314876336,7036491.65084485,2022/10/04 23:00:00+00,Wed 05 Oct 2022,49,37,0,3858780,3813177,241064,4099844,4054241,85.4397783982933,84.4894226739542,646
-856336.314876336,7036491.65084485,2022/10/05 23:00:00+00,Thu 06 Oct 2022,59,26,0,3858839,3813203,241064,4099903,4054267,85.4410079443262,84.4899645077992,647
-856336.314876336,7036491.65084485,2022/10/06 23:00:00+00,Fri 07 Oct 2022,82,40,0,3858921,3813243,241064,4099985,4054307,85.4427168049142,84.4907980983299,648
-856336.314876336,7036491.65084485,2022/10/07 23:00:00+00,Sat 08 Oct 2022,100,102,0,3859021,3813345,241064,4100085,4054409,85.444800781241,84.4929237541833,649
-856336.314876336,7036491.65084485,2022/10/08 23:00:00+00,Sun 09 Oct 2022,38,28,0,3859059,3813373,241064,4100123,4054437,85.4455926922453,84.4935072675548,650
-856336.314876336,7036491.65084485,2022/10/09 23:00:00+00,Mon 10 Oct 2022,19,2,0,3859078,3813375,241064,4100142,4054439,85.4459886477474,84.4935489470814,651
-856336.314876336,7036491.65084485,2022/10/10 23:00:00+00,Tue 11 Oct 2022,80,14,0,3859158,3813389,241064,4100222,4054453,85.4476558288088,84.4938407037671,652
-856336.314876336,7036491.65084485,2022/10/11 23:00:00+00,Wed 12 Oct 2022,57,36,0,3859215,3813425,241064,4100279,4054489,85.4488436953152,84.4945909352448,653
-856336.314876336,7036491.65084485,2022/10/12 23:00:00+00,Thu 13 Oct 2022,80,29,0,3859295,3813454,241064,4100359,4054518,85.4505108763767,84.4951952883796,654
-856336.314876336,7036491.65084485,2022/10/13 23:00:00+00,Fri 14 Oct 2022,131,21,0,3859426,3813475,241064,4100490,4054539,85.4532408853648,84.4956329234083,655
-856336.314876336,7036491.65084485,2022/10/14 23:00:00+00,Sat 15 Oct 2022,97,120,0,3859523,3813595,241064,4100587,4054659,85.4552623424019,84.4981336950005,656
-856336.314876336,7036491.65084485,2022/10/15 23:00:00+00,Sun 16 Oct 2022,26,37,1,3859549,3813632,241065,4100614,4054697,85.4558250160102,84.4989256060047,657
-856336.314876336,7036491.65084485,2022/10/16 23:00:00+00,Mon 17 Oct 2022,58,3,0,3859607,3813635,241065,4100672,4054700,85.4570337222797,84.4989881252945,658
-856336.314876336,7036491.65084485,2022/10/17 23:00:00+00,Tue 18 Oct 2022,119,17,0,3859726,3813652,241065,4100791,4054717,85.4595136541087,84.4993424012701,659
-856336.314876336,7036491.65084485,2022/10/18 23:00:00+00,Wed 19 Oct 2022,88,40,0,3859814,3813692,241065,4100879,4054757,85.4613475532763,84.5001759918008,660
-856336.314876336,7036491.65084485,2022/10/19 23:00:00+00,Thu 20 Oct 2022,124,9,0,3859938,3813701,241065,4101003,4054766,85.4639316839216,84.5003635496702,661
-856336.314876336,7036491.65084485,2022/10/20 23:00:00+00,Fri 21 Oct 2022,134,18,0,3860072,3813719,241065,4101137,4054784,85.4667242121996,84.5007386654091,662
-856336.314876336,7036491.65084485,2022/10/21 23:00:00+00,Sat 22 Oct 2022,101,56,0,3860173,3813775,241065,4101238,4054840,85.4688290282898,84.5019056921521,663
-856336.314876336,7036491.65084485,2022/10/22 23:00:00+00,Sun 23 Oct 2022,81,47,0,3860254,3813822,241065,4101319,4054887,85.4705170491145,84.5028851610257,664
-856336.314876336,7036491.65084485,2022/10/23 23:00:00+00,Mon 24 Oct 2022,76,4,0,3860330,3813826,241065,4101395,4054891,85.4721008711229,84.5029685200788,665
-856336.314876336,7036491.65084485,2022/10/24 23:00:00+00,Tue 25 Oct 2022,74,26,0,3860404,3813852,241065,4101469,4054917,85.4736430136048,84.5035103539238,666
-856336.314876336,7036491.65084485,2022/10/25 23:00:00+00,Wed 26 Oct 2022,46,25,0,3860450,3813877,241065,4101515,4054942,85.4746016427152,84.5040313480055,667
-856336.314876336,7036491.65084485,2022/10/26 23:00:00+00,Thu 27 Oct 2022,64,34,0,3860514,3813911,241065,4101579,4054976,85.4759353875644,84.5047398999566,668
-856336.314876336,7036491.65084485,2022/10/27 23:00:00+00,Fri 28 Oct 2022,59,19,0,3860573,3813930,241065,4101638,4054995,85.4771649335972,84.5051358554587,669
-856336.314876336,7036491.65084485,2022/10/28 23:00:00+00,Sat 29 Oct 2022,91,61,0,3860664,3813991,241065,4101729,4055056,85.4790613520547,84.5064070810181,670
-856336.314876336,7036491.65084485,2022/10/29 23:00:00+00,Sun 30 Oct 2022,11,6,0,3860675,3813997,241065,4101740,4055062,85.4792905894506,84.5065321195977,671
-856336.314876336,7036491.65084485,2022/10/31 00:00:00+00,Mon 31 Oct 2022,1,1,0,3860676,3813998,241065,4101741,4055063,85.4793114292139,84.506552959361,672
-856336.314876336,7036491.65084485,2022/11/01 00:00:00+00,Tue 01 Nov 2022,98,24,0,3860774,3814022,241065,4101839,4055087,85.4813537260142,84.5070531136794,673
-856336.314876336,7036491.65084485,2022/11/02 00:00:00+00,Wed 02 Nov 2022,119,12,0,3860893,3814034,241065,4101958,4055099,85.4838336578432,84.5073031908387,674
-856336.314876336,7036491.65084485,2022/11/03 00:00:00+00,Thu 03 Nov 2022,92,28,0,3860985,3814062,241065,4102050,4055127,85.4857509160639,84.5078867042102,675
-856336.314876336,7036491.65084485,2022/11/04 00:00:00+00,Fri 04 Nov 2022,60,21,0,3861045,3814083,241065,4102110,4055148,85.48700130186,84.5083243392388,676
-856336.314876336,7036491.65084485,2022/11/05 00:00:00+00,Sat 05 Nov 2022,47,54,0,3861092,3814137,241065,4102157,4055202,85.4879807707336,84.5094496864553,677
-856336.314876336,7036491.65084485,2022/11/06 00:00:00+00,Sun 06 Nov 2022,56,76,0,3861148,3814213,241065,4102213,4055278,85.4891477974767,84.5110335084638,678
-856336.314876336,7036491.65084485,2022/11/07 00:00:00+00,Mon 07 Nov 2022,42,4,0,3861190,3814217,241065,4102255,4055282,85.490023067534,84.5111168675168,679
-856336.314876336,7036491.65084485,2022/11/08 00:00:00+00,Tue 08 Nov 2022,71,28,0,3861261,3814245,241065,4102326,4055310,85.491502690726,84.5117003808884,680
-856336.314876336,7036491.65084485,2022/11/09 00:00:00+00,Wed 09 Nov 2022,88,32,0,3861349,3814277,241065,4102414,4055342,85.4933365898937,84.5123672533129,681
-856336.314876336,7036491.65084485,2022/11/10 00:00:00+00,Thu 10 Nov 2022,48,15,0,3861397,3814292,241065,4102462,4055357,85.4943368985306,84.512679849762,682
-856336.314876336,7036491.65084485,2022/11/11 00:00:00+00,Fri 11 Nov 2022,50,16,0,3861447,3814308,241065,4102512,4055373,85.495378886694,84.5130132859743,683
-856336.314876336,7036491.65084485,2022/11/12 00:00:00+00,Sat 12 Nov 2022,75,87,0,3861522,3814395,241065,4102587,4055460,85.4969418689391,84.5148263453787,684
-856336.314876336,7036491.65084485,2022/11/13 00:00:00+00,Sun 13 Nov 2022,45,60,0,3861567,3814455,241065,4102632,4055520,85.4978796582862,84.5160767311748,685
-856336.314876336,7036491.65084485,2022/11/14 00:00:00+00,Mon 14 Nov 2022,16,2,0,3861583,3814457,241065,4102648,4055522,85.4982130944985,84.5161184107013,686
-856336.314876336,7036491.65084485,2022/11/15 00:00:00+00,Tue 15 Nov 2022,58,6,0,3861641,3814463,241065,4102706,4055528,85.4994218007681,84.5162434492809,687
-856336.314876336,7036491.65084485,2022/11/16 00:00:00+00,Wed 16 Nov 2022,47,20,0,3861688,3814483,241065,4102753,4055548,85.5004012696417,84.5166602445463,688
-856336.314876336,7036491.65084485,2022/11/17 00:00:00+00,Thu 17 Nov 2022,64,8,1,3861752,3814491,241066,4102818,4055557,85.5017558542542,84.5168478024157,689
-856336.314876336,7036491.65084485,2022/11/18 00:00:00+00,Fri 18 Nov 2022,29,22,0,3861781,3814513,241066,4102847,4055579,85.502360207389,84.5173062772076,690
-856336.314876336,7036491.65084485,2022/11/19 00:00:00+00,Sat 19 Nov 2022,54,57,0,3861835,3814570,241066,4102901,4055636,85.5034855546055,84.5184941437139,691
-856336.314876336,7036491.65084485,2022/11/20 00:00:00+00,Sun 20 Nov 2022,43,53,0,3861878,3814623,241066,4102944,4055689,85.504381664426,84.5195986511672,692
-856336.314876336,7036491.65084485,2022/11/21 00:00:00+00,Mon 21 Nov 2022,18,3,0,3861896,3814626,241066,4102962,4055692,85.5047567801649,84.519661170457,693
-856336.314876336,7036491.65084485,2022/11/22 00:00:00+00,Tue 22 Nov 2022,49,22,0,3861945,3814648,241066,4103011,4055714,85.505777928565,84.5201196452489,694
-856336.314876336,7036491.65084485,2022/11/23 00:00:00+00,Wed 23 Nov 2022,23,16,0,3861968,3814664,241066,4103034,4055730,85.5062572431202,84.5204530814612,695
-856336.314876336,7036491.65084485,2022/11/24 00:00:00+00,Thu 24 Nov 2022,26,16,0,3861994,3814680,241066,4103060,4055746,85.5067990769652,84.5207865176735,696
-856336.314876336,7036491.65084485,2022/11/25 00:00:00+00,Fri 25 Nov 2022,20,9,0,3862014,3814689,241066,4103080,4055755,85.5072158722306,84.5209740755429,697
-856336.314876336,7036491.65084485,2022/11/26 00:00:00+00,Sat 26 Nov 2022,66,62,0,3862080,3814751,241066,4103146,4055817,85.5085912966063,84.5222661408655,698
-856336.314876336,7036491.65084485,2022/11/27 00:00:00+00,Sun 27 Nov 2022,35,42,0,3862115,3814793,241066,4103181,4055859,85.5093206883207,84.5231414109228,699
-856336.314876336,7036491.65084485,2022/11/28 00:00:00+00,Mon 28 Nov 2022,17,0,0,3862132,3814793,241066,4103198,4055859,85.5096749642963,84.5231414109228,700
-856336.314876336,7036491.65084485,2022/11/29 00:00:00+00,Tue 29 Nov 2022,33,15,0,3862165,3814808,241066,4103231,4055874,85.5103626764841,84.5234540073719,701
-856336.314876336,7036491.65084485,2022/11/30 00:00:00+00,Wed 30 Nov 2022,46,8,0,3862211,3814816,241066,4103277,4055882,85.5113213055945,84.523620725478,702
-856336.314876336,7036491.65084485,2022/12/01 00:00:00+00,Thu 01 Dec 2022,20,7,0,3862231,3814823,241066,4103297,4055889,85.5117381008599,84.5237666038209,703
-856336.314876336,7036491.65084485,2022/12/02 00:00:00+00,Fri 02 Dec 2022,19,13,0,3862250,3814836,241066,4103316,4055902,85.512134056362,84.5240375207434,704
-856336.314876336,7036491.65084485,2022/12/03 00:00:00+00,Sat 03 Dec 2022,45,60,0,3862295,3814896,241066,4103361,4055962,85.5130718457091,84.5252879065395,705
-856336.314876336,7036491.65084485,2022/12/04 00:00:00+00,Sun 04 Dec 2022,72,40,0,3862367,3814936,241066,4103433,4056002,85.5145723086644,84.5261214970702,706
